name	sequence
synA1(WT)	TATGGAAATAATACTATTTCAGCCAGACCGACAACAGCTGTTAATTGAACGCACTAACGCAATATTGTGATAGAGTAATGATACGACTCACGAATTTGTGAAAGTTGAATGGAGGGGAAAATCTAATATGTTGGGAAGTCCGAGTAGAGTTACCTGTATGGGAGAGTTAG
synA1(+TATA)	TATGGAAATAATACTATTTCAGCCAGACCGACAACAGCTGTTAATTGAACGCACTAACGCAATATTGTGATAGAGTAATGATACGACTCACGAATTTGTGAAAGTTGAATGGAGGGGAAAATCTAATATGTTTATAAATACGAGTAGAGTTACCTGTATGGGAGAGTTAG
synA1(+Inr)	TATGGAAATAATACTATTTCAGCCAGACCGACAACAGCTGTTAATTGAACGCACTAACGCAATATTGTGATAGAGTAATGATACGACTCACGAATTTGTGAAAGTTGAATGGAGGGGAAAATCTAATATGTTGGGAAGTCCGAGTAGAGTTACCTGTATCCCTTCATTTG
synA1(+Ypatch)	TATGGAAATAATACTATTTCAGCCAGACCGACAACAGCTGTTAATTGAACGCACTAACGCAATATTGTGATAGAGTAATGATACGACTCACGAATTTGTGAAAGTTGAATGGAGGGGAAAATCTAATATGTTGGGAAGTCCGAGTACCCTTCCCTGTATGGGAGAGTTAG
synA1(+TATA+Inr)	TATGGAAATAATACTATTTCAGCCAGACCGACAACAGCTGTTAATTGAACGCACTAACGCAATATTGTGATAGAGTAATGATACGACTCACGAATTTGTGAAAGTTGAATGGAGGGGAAAATCTAATATGTTTATAAATACGAGTAGAGTTACCTGTATCCCTTCATTTG
synA1(+TATA+Ypatch)	TATGGAAATAATACTATTTCAGCCAGACCGACAACAGCTGTTAATTGAACGCACTAACGCAATATTGTGATAGAGTAATGATACGACTCACGAATTTGTGAAAGTTGAATGGAGGGGAAAATCTAATATGTTTATAAATACGAGTACCCTTCCCTGTATGGGAGAGTTAG
synA1(+Inr+Ypatch)	TATGGAAATAATACTATTTCAGCCAGACCGACAACAGCTGTTAATTGAACGCACTAACGCAATATTGTGATAGAGTAATGATACGACTCACGAATTTGTGAAAGTTGAATGGAGGGGAAAATCTAATATGTTGGGAAGTCCGAGTACCCTTCCCTGTATCCCTTCATTTG
synA1(+TATA+Inr+Ypatch)	TATGGAAATAATACTATTTCAGCCAGACCGACAACAGCTGTTAATTGAACGCACTAACGCAATATTGTGATAGAGTAATGATACGACTCACGAATTTGTGAAAGTTGAATGGAGGGGAAAATCTAATATGTTTATAAATACGAGTACCCTTCCCTGTATCCCTTCATTTG
synZ1(WT)	ACAAAAGCTGTAACGAGTCACTAGGCGGCAAAGAGCCGTATGGCAATTCCATGACGTTTGGAATCACTCTAGACAGGGCGTCACCCGGTCAGCACGACTTATGGAAACGTTTTCGGAGCAACTTGTCATCCAGCGAATACCAACGCGATGAGTGGTTAGCGGCAAAGTTA
synZ1(+TATA)	ACAAAAGCTGTAACGAGTCACTAGGCGGCAAAGAGCCGTATGGCAATTCCATGACGTTTGGAATCACTCTAGACAGGGCGTCACCCGGTCAGCACGACTTATGGAAACGTTTTCGGAGCAACTTGTCATCCATATAAATACAACGCGATGAGTGGTTAGCGGCAAAGTTA
synZ1(+Inr)	ACAAAAGCTGTAACGAGTCACTAGGCGGCAAAGAGCCGTATGGCAATTCCATGACGTTTGGAATCACTCTAGACAGGGCGTCACCCGGTCAGCACGACTTATGGAAACGTTTTCGGAGCAACTTGTCATCCAGCGAATACCAACGCGATGAGTGGTTAGCCCCTCACTTA
synZ1(+Ypatch)	ACAAAAGCTGTAACGAGTCACTAGGCGGCAAAGAGCCGTATGGCAATTCCATGACGTTTGGAATCACTCTAGACAGGGCGTCACCCGGTCAGCACGACTTATGGAAACGTTTTCGGAGCAACTTGTCATCCAGCGAATACCAACGCCCTCCCTCGTTAGCGGCAAAGTTA
synZ1(+TATA+Inr)	ACAAAAGCTGTAACGAGTCACTAGGCGGCAAAGAGCCGTATGGCAATTCCATGACGTTTGGAATCACTCTAGACAGGGCGTCACCCGGTCAGCACGACTTATGGAAACGTTTTCGGAGCAACTTGTCATCCATATAAATACAACGCGATGAGTGGTTAGCCCCTCACTTA
synZ1(+TATA+Ypatch)	ACAAAAGCTGTAACGAGTCACTAGGCGGCAAAGAGCCGTATGGCAATTCCATGACGTTTGGAATCACTCTAGACAGGGCGTCACCCGGTCAGCACGACTTATGGAAACGTTTTCGGAGCAACTTGTCATCCATATAAATACAACGCCCTCCCTCGTTAGCGGCAAAGTTA
synZ1(+Inr+Ypatch)	ACAAAAGCTGTAACGAGTCACTAGGCGGCAAAGAGCCGTATGGCAATTCCATGACGTTTGGAATCACTCTAGACAGGGCGTCACCCGGTCAGCACGACTTATGGAAACGTTTTCGGAGCAACTTGTCATCCAGCGAATACCAACGCCCTCCCTCGTTAGCCCCTCACTTA
synZ1(+TATA+Inr+Ypatch)	ACAAAAGCTGTAACGAGTCACTAGGCGGCAAAGAGCCGTATGGCAATTCCATGACGTTTGGAATCACTCTAGACAGGGCGTCACCCGGTCAGCACGACTTATGGAAACGTTTTCGGAGCAACTTGTCATCCATATAAATACAACGCCCTCCCTCGTTAGCCCCTCACTTA
synA2(WT)	GAAGGTATCGAAAATGATAACTACGATGACATTTATAGTGTCAATCATCACATATCCGATCCAGTATTATTCATTAGAATAGGTAACTGTACCGATCAACAAGTTAACAAACGTTCTGACATGGTAGTTATTTTAAGATGTTGAAACATTGGATTTGCTGAATAATGATA
synA2(+TATA)	GAAGGTATCGAAAATGATAACTACGATGACATTTATAGTGTCAATCATCACATATCCGATCCAGTATTATTCATTAGAATAGGTAACTGTACCGATCAACAAGTTAACAAACGTTCTGACATGGTAGTTATTTATAAATATTGAAACATTGGATTTGCTGAATAATGATA
synA2(+Inr)	GAAGGTATCGAAAATGATAACTACGATGACATTTATAGTGTCAATCATCACATATCCGATCCAGTATTATTCATTAGAATAGGTAACTGTACCGATCAACAAGTTAACAAACGTTCTGACATGGTAGTTATTTTAAGATGTTGAAACATTGGATTTGCTCTTTTCACTTA
synA2(+Ypatch)	GAAGGTATCGAAAATGATAACTACGATGACATTTATAGTGTCAATCATCACATATCCGATCCAGTATTATTCATTAGAATAGGTAACTGTACCGATCAACAAGTTAACAAACGTTCTGACATGGTAGTTATTTTAAGATGTTGAAACCTTCCCTTTGCTGAATAATGATA
synA2(+TATA+Inr)	GAAGGTATCGAAAATGATAACTACGATGACATTTATAGTGTCAATCATCACATATCCGATCCAGTATTATTCATTAGAATAGGTAACTGTACCGATCAACAAGTTAACAAACGTTCTGACATGGTAGTTATTTATAAATATTGAAACATTGGATTTGCTCTTTTCACTTA
synA2(+TATA+Ypatch)	GAAGGTATCGAAAATGATAACTACGATGACATTTATAGTGTCAATCATCACATATCCGATCCAGTATTATTCATTAGAATAGGTAACTGTACCGATCAACAAGTTAACAAACGTTCTGACATGGTAGTTATTTATAAATATTGAAACCTTCCCTTTGCTGAATAATGATA
synA2(+Inr+Ypatch)	GAAGGTATCGAAAATGATAACTACGATGACATTTATAGTGTCAATCATCACATATCCGATCCAGTATTATTCATTAGAATAGGTAACTGTACCGATCAACAAGTTAACAAACGTTCTGACATGGTAGTTATTTTAAGATGTTGAAACCTTCCCTTTGCTCTTTTCACTTA
synA2(+TATA+Inr+Ypatch)	GAAGGTATCGAAAATGATAACTACGATGACATTTATAGTGTCAATCATCACATATCCGATCCAGTATTATTCATTAGAATAGGTAACTGTACCGATCAACAAGTTAACAAACGTTCTGACATGGTAGTTATTTATAAATATTGAAACCTTCCCTTTGCTCTTTTCACTTA
synZ2(WT)	CACTGATGTTAGTAGAGATAATGCTGTTAGCTTTAAGCTTCGGCAGGTATGGGATTTAGACAGAATGCAATTACTAATGGAAAGTTTTGTGTCTCGTTAGTGGCTGAATGCGGTAAAGTGCTGTTTCGCGCGTACCCCGAGTCAACCGCTTAGGGCGGACATCAGGGGAC
synZ2(+TATA)	CACTGATGTTAGTAGAGATAATGCTGTTAGCTTTAAGCTTCGGCAGGTATGGGATTTAGACAGAATGCAATTACTAATGGAAAGTTTTGTGTCTCGTTAGTGGCTGAATGCGGTAAAGTGCTGTTTCGCGCGTATAAATAGTCAACCGCTTAGGGCGGACATCAGGGGAC
synZ2(+Inr)	CACTGATGTTAGTAGAGATAATGCTGTTAGCTTTAAGCTTCGGCAGGTATGGGATTTAGACAGAATGCAATTACTAATGGAAAGTTTTGTGTCTCGTTAGTGGCTGAATGCGGTAAAGTGCTGTTTCGCGCGTACCCCGAGTCAACCGCTTAGGGCGGACTTCTCACCTC
synZ2(+Ypatch)	CACTGATGTTAGTAGAGATAATGCTGTTAGCTTTAAGCTTCGGCAGGTATGGGATTTAGACAGAATGCAATTACTAATGGAAAGTTTTGTGTCTCGTTAGTGGCTGAATGCGGTAAAGTGCTGTTTCGCGCGTACCCCGAGTCAACCCCTTCCCGCGGACATCAGGGGAC
synZ2(+TATA+Inr)	CACTGATGTTAGTAGAGATAATGCTGTTAGCTTTAAGCTTCGGCAGGTATGGGATTTAGACAGAATGCAATTACTAATGGAAAGTTTTGTGTCTCGTTAGTGGCTGAATGCGGTAAAGTGCTGTTTCGCGCGTATAAATAGTCAACCGCTTAGGGCGGACTTCTCACCTC
synZ2(+TATA+Ypatch)	CACTGATGTTAGTAGAGATAATGCTGTTAGCTTTAAGCTTCGGCAGGTATGGGATTTAGACAGAATGCAATTACTAATGGAAAGTTTTGTGTCTCGTTAGTGGCTGAATGCGGTAAAGTGCTGTTTCGCGCGTATAAATAGTCAACCCCTTCCCGCGGACATCAGGGGAC
synZ2(+Inr+Ypatch)	CACTGATGTTAGTAGAGATAATGCTGTTAGCTTTAAGCTTCGGCAGGTATGGGATTTAGACAGAATGCAATTACTAATGGAAAGTTTTGTGTCTCGTTAGTGGCTGAATGCGGTAAAGTGCTGTTTCGCGCGTACCCCGAGTCAACCCCTTCCCGCGGACTTCTCACCTC
synZ2(+TATA+Inr+Ypatch)	CACTGATGTTAGTAGAGATAATGCTGTTAGCTTTAAGCTTCGGCAGGTATGGGATTTAGACAGAATGCAATTACTAATGGAAAGTTTTGTGTCTCGTTAGTGGCTGAATGCGGTAAAGTGCTGTTTCGCGCGTATAAATAGTCAACCCCTTCCCGCGGACTTCTCACCTC
synA3(WT)	GCCATAATAACATCGAATAACAAACACTTTATGACCGCTGTATACATCATCTAATTTAGTGATTGGAAAAAATATGTCGGGATTCTTGAGTGATTAAAAGTATGTTTAATTGTACAGAGGACTTTGTACACTAAACAGTTTGTCGTGAAGCTAGTCGATAATTAAACCAT
synA3(+TATA)	GCCATAATAACATCGAATAACAAACACTTTATGACCGCTGTATACATCATCTAATTTAGTGATTGGAAAAAATATGTCGGGATTCTTGAGTGATTAAAAGTATGTTTAATTGTACAGAGGACTTTGTACACTTATAAATATGTCGTGAAGCTAGTCGATAATTAAACCAT
synA3(+Inr)	GCCATAATAACATCGAATAACAAACACTTTATGACCGCTGTATACATCATCTAATTTAGTGATTGGAAAAAATATGTCGGGATTCTTGAGTGATTAAAAGTATGTTTAATTGTACAGAGGACTTTGTACACTAAACAGTTTGTCGTGAAGCTAGTCGATTTTTTCACCTT
synA3(+Ypatch)	GCCATAATAACATCGAATAACAAACACTTTATGACCGCTGTATACATCATCTAATTTAGTGATTGGAAAAAATATGTCGGGATTCTTGAGTGATTAAAAGTATGTTTAATTGTACAGAGGACTTTGTACACTAAACAGTTTGTCGTCCCCCTCCTCGATAATTAAACCAT
synA3(+TATA+Inr)	GCCATAATAACATCGAATAACAAACACTTTATGACCGCTGTATACATCATCTAATTTAGTGATTGGAAAAAATATGTCGGGATTCTTGAGTGATTAAAAGTATGTTTAATTGTACAGAGGACTTTGTACACTTATAAATATGTCGTGAAGCTAGTCGATTTTTTCACCTT
synA3(+TATA+Ypatch)	GCCATAATAACATCGAATAACAAACACTTTATGACCGCTGTATACATCATCTAATTTAGTGATTGGAAAAAATATGTCGGGATTCTTGAGTGATTAAAAGTATGTTTAATTGTACAGAGGACTTTGTACACTTATAAATATGTCGTCCCCCTCCTCGATAATTAAACCAT
synA3(+Inr+Ypatch)	GCCATAATAACATCGAATAACAAACACTTTATGACCGCTGTATACATCATCTAATTTAGTGATTGGAAAAAATATGTCGGGATTCTTGAGTGATTAAAAGTATGTTTAATTGTACAGAGGACTTTGTACACTAAACAGTTTGTCGTCCCCCTCCTCGATTTTTTCACCTT
synA3(+TATA+Inr+Ypatch)	GCCATAATAACATCGAATAACAAACACTTTATGACCGCTGTATACATCATCTAATTTAGTGATTGGAAAAAATATGTCGGGATTCTTGAGTGATTAAAAGTATGTTTAATTGTACAGAGGACTTTGTACACTTATAAATATGTCGTCCCCCTCCTCGATTTTTTCACCTT
synZ3(WT)	TCGGTAACCCGGTGCTTAACGTTAGCCAACGAGCGAGTAAACGGTTTACGGCCACCCAAATCGATGTATGCCACACCACGCACTAGCAGTAGTACAATACTCGTATCATCGTCAGCTGCATCGCAATCAACTCCAATGCAACTTAGATGAAAGATACATGATACCTATCC
synZ3(+TATA)	TCGGTAACCCGGTGCTTAACGTTAGCCAACGAGCGAGTAAACGGTTTACGGCCACCCAAATCGATGTATGCCACACCACGCACTAGCAGTAGTACAATACTCGTATCATCGTCAGCTGCATCGCAATCAACTTATAAATAACTTAGATGAAAGATACATGATACCTATCC
synZ3(+Inr)	TCGGTAACCCGGTGCTTAACGTTAGCCAACGAGCGAGTAAACGGTTTACGGCCACCCAAATCGATGTATGCCACACCACGCACTAGCAGTAGTACAATACTCGTATCATCGTCAGCTGCATCGCAATCAACTCCAATGCAACTTAGATGAAAGATACATCTTTTCATTCC
synZ3(+Ypatch)	TCGGTAACCCGGTGCTTAACGTTAGCCAACGAGCGAGTAAACGGTTTACGGCCACCCAAATCGATGTATGCCACACCACGCACTAGCAGTAGTACAATACTCGTATCATCGTCAGCTGCATCGCAATCAACTCCAATGCAACTTAGCTCCCCCCTACATGATACCTATCC
synZ3(+TATA+Inr)	TCGGTAACCCGGTGCTTAACGTTAGCCAACGAGCGAGTAAACGGTTTACGGCCACCCAAATCGATGTATGCCACACCACGCACTAGCAGTAGTACAATACTCGTATCATCGTCAGCTGCATCGCAATCAACTTATAAATAACTTAGATGAAAGATACATCTTTTCATTCC
synZ3(+TATA+Ypatch)	TCGGTAACCCGGTGCTTAACGTTAGCCAACGAGCGAGTAAACGGTTTACGGCCACCCAAATCGATGTATGCCACACCACGCACTAGCAGTAGTACAATACTCGTATCATCGTCAGCTGCATCGCAATCAACTTATAAATAACTTAGCTCCCCCCTACATGATACCTATCC
synZ3(+Inr+Ypatch)	TCGGTAACCCGGTGCTTAACGTTAGCCAACGAGCGAGTAAACGGTTTACGGCCACCCAAATCGATGTATGCCACACCACGCACTAGCAGTAGTACAATACTCGTATCATCGTCAGCTGCATCGCAATCAACTCCAATGCAACTTAGCTCCCCCCTACATCTTTTCATTCC
synZ3(+TATA+Inr+Ypatch)	TCGGTAACCCGGTGCTTAACGTTAGCCAACGAGCGAGTAAACGGTTTACGGCCACCCAAATCGATGTATGCCACACCACGCACTAGCAGTAGTACAATACTCGTATCATCGTCAGCTGCATCGCAATCAACTTATAAATAACTTAGCTCCCCCCTACATCTTTTCATTCC
synA4(WT)	ACAAGTTATGATTCTTGATTGACGAAAGGTTGATGACTTCGAATTGTAAAAGAAAATAAACATGCAAGTAAGTTGTCTGCGATAAAGGGATTTACTCAGTGGTCAGAACTAGAGATATCACGTACACTTTTGTAACTAGACCTACTGAATGATATGACTTACGGGAGCTA
synA4(+TATA)	ACAAGTTATGATTCTTGATTGACGAAAGGTTGATGACTTCGAATTGTAAAAGAAAATAAACATGCAAGTAAGTTGTCTGCGATAAAGGGATTTACTCAGTGGTCAGAACTAGAGATATCACGTACACTTTTGTATAAATACCTACTGAATGATATGACTTACGGGAGCTA
synA4(+Inr)	ACAAGTTATGATTCTTGATTGACGAAAGGTTGATGACTTCGAATTGTAAAAGAAAATAAACATGCAAGTAAGTTGTCTGCGATAAAGGGATTTACTCAGTGGTCAGAACTAGAGATATCACGTACACTTTTGTAACTAGACCTACTGAATGATATGACTTTCCTCACCTA
synA4(+Ypatch)	ACAAGTTATGATTCTTGATTGACGAAAGGTTGATGACTTCGAATTGTAAAAGAAAATAAACATGCAAGTAAGTTGTCTGCGATAAAGGGATTTACTCAGTGGTCAGAACTAGAGATATCACGTACACTTTTGTAACTAGACCTACTCCCTCCTCTGACTTACGGGAGCTA
synA4(+TATA+Inr)	ACAAGTTATGATTCTTGATTGACGAAAGGTTGATGACTTCGAATTGTAAAAGAAAATAAACATGCAAGTAAGTTGTCTGCGATAAAGGGATTTACTCAGTGGTCAGAACTAGAGATATCACGTACACTTTTGTATAAATACCTACTGAATGATATGACTTTCCTCACCTA
synA4(+TATA+Ypatch)	ACAAGTTATGATTCTTGATTGACGAAAGGTTGATGACTTCGAATTGTAAAAGAAAATAAACATGCAAGTAAGTTGTCTGCGATAAAGGGATTTACTCAGTGGTCAGAACTAGAGATATCACGTACACTTTTGTATAAATACCTACTCCCTCCTCTGACTTACGGGAGCTA
synA4(+Inr+Ypatch)	ACAAGTTATGATTCTTGATTGACGAAAGGTTGATGACTTCGAATTGTAAAAGAAAATAAACATGCAAGTAAGTTGTCTGCGATAAAGGGATTTACTCAGTGGTCAGAACTAGAGATATCACGTACACTTTTGTAACTAGACCTACTCCCTCCTCTGACTTTCCTCACCTA
synA4(+TATA+Inr+Ypatch)	ACAAGTTATGATTCTTGATTGACGAAAGGTTGATGACTTCGAATTGTAAAAGAAAATAAACATGCAAGTAAGTTGTCTGCGATAAAGGGATTTACTCAGTGGTCAGAACTAGAGATATCACGTACACTTTTGTATAAATACCTACTCCCTCCTCTGACTTTCCTCACCTA
synZ4(WT)	GATCAAAAGTTGTATACCAACAGAGACTGTAAGCGGCACAGGAAAGCTGACATCTTTAAGGGCTATACACCCGACTGCATGGTGAGCTAAGACATCGTATACCTTGCGACCTATCGGCGTTCATCCGCAAATCATCCGAAAACACGCGATTCCTGGGTCGGGGGACTCTC
synZ4(+TATA)	GATCAAAAGTTGTATACCAACAGAGACTGTAAGCGGCACAGGAAAGCTGACATCTTTAAGGGCTATACACCCGACTGCATGGTGAGCTAAGACATCGTATACCTTGCGACCTATCGGCGTTCATCCGCAAATTATAAATAAACACGCGATTCCTGGGTCGGGGGACTCTC
synZ4(+Inr)	GATCAAAAGTTGTATACCAACAGAGACTGTAAGCGGCACAGGAAAGCTGACATCTTTAAGGGCTATACACCCGACTGCATGGTGAGCTAAGACATCGTATACCTTGCGACCTATCGGCGTTCATCCGCAAATCATCCGAAAACACGCGATTCCTGGGTCCCCCTCATCTC
synZ4(+Ypatch)	GATCAAAAGTTGTATACCAACAGAGACTGTAAGCGGCACAGGAAAGCTGACATCTTTAAGGGCTATACACCCGACTGCATGGTGAGCTAAGACATCGTATACCTTGCGACCTATCGGCGTTCATCCGCAAATCATCCGAAAACACGCCCTTCCTGGGTCGGGGGACTCTC
synZ4(+TATA+Inr)	GATCAAAAGTTGTATACCAACAGAGACTGTAAGCGGCACAGGAAAGCTGACATCTTTAAGGGCTATACACCCGACTGCATGGTGAGCTAAGACATCGTATACCTTGCGACCTATCGGCGTTCATCCGCAAATTATAAATAAACACGCGATTCCTGGGTCCCCCTCATCTC
synZ4(+TATA+Ypatch)	GATCAAAAGTTGTATACCAACAGAGACTGTAAGCGGCACAGGAAAGCTGACATCTTTAAGGGCTATACACCCGACTGCATGGTGAGCTAAGACATCGTATACCTTGCGACCTATCGGCGTTCATCCGCAAATTATAAATAAACACGCCCTTCCTGGGTCGGGGGACTCTC
synZ4(+Inr+Ypatch)	GATCAAAAGTTGTATACCAACAGAGACTGTAAGCGGCACAGGAAAGCTGACATCTTTAAGGGCTATACACCCGACTGCATGGTGAGCTAAGACATCGTATACCTTGCGACCTATCGGCGTTCATCCGCAAATCATCCGAAAACACGCCCTTCCTGGGTCCCCCTCATCTC
synZ4(+TATA+Inr+Ypatch)	GATCAAAAGTTGTATACCAACAGAGACTGTAAGCGGCACAGGAAAGCTGACATCTTTAAGGGCTATACACCCGACTGCATGGTGAGCTAAGACATCGTATACCTTGCGACCTATCGGCGTTCATCCGCAAATTATAAATAAACACGCCCTTCCTGGGTCCCCCTCATCTC
synA5(WT)	CCTTACGAGGAAAAAAAATTGCAAGTAATTTGATGATCATATTAGAGGTACTAGTTTGTAGTTTTACGGTCCTAAGTTAGTCTACACTATTTGATTAACTTGCGATCACTATTAGTCATAGACAAAGACGTATCAAAAGTAAGGCTGTGTAACGAATACATGCTTTTAAA
synA5(+TATA)	CCTTACGAGGAAAAAAAATTGCAAGTAATTTGATGATCATATTAGAGGTACTAGTTTGTAGTTTTACGGTCCTAAGTTAGTCTACACTATTTGATTAACTTGCGATCACTATTAGTCATAGACAAAGACGTATATAAATAAAGGCTGTGTAACGAATACATGCTTTTAAA
synA5(+Inr)	CCTTACGAGGAAAAAAAATTGCAAGTAATTTGATGATCATATTAGAGGTACTAGTTTGTAGTTTTACGGTCCTAAGTTAGTCTACACTATTTGATTAACTTGCGATCACTATTAGTCATAGACAAAGACGTATCAAAAGTAAGGCTGTGTAACGAATACTTCCTCATTTA
synA5(+Ypatch)	CCTTACGAGGAAAAAAAATTGCAAGTAATTTGATGATCATATTAGAGGTACTAGTTTGTAGTTTTACGGTCCTAAGTTAGTCTACACTATTTGATTAACTTGCGATCACTATTAGTCATAGACAAAGACGTATCAAAAGTAAGGCTCTCTCCCCAATACATGCTTTTAAA
synA5(+TATA+Inr)	CCTTACGAGGAAAAAAAATTGCAAGTAATTTGATGATCATATTAGAGGTACTAGTTTGTAGTTTTACGGTCCTAAGTTAGTCTACACTATTTGATTAACTTGCGATCACTATTAGTCATAGACAAAGACGTATATAAATAAAGGCTGTGTAACGAATACTTCCTCATTTA
synA5(+TATA+Ypatch)	CCTTACGAGGAAAAAAAATTGCAAGTAATTTGATGATCATATTAGAGGTACTAGTTTGTAGTTTTACGGTCCTAAGTTAGTCTACACTATTTGATTAACTTGCGATCACTATTAGTCATAGACAAAGACGTATATAAATAAAGGCTCTCTCCCCAATACATGCTTTTAAA
synA5(+Inr+Ypatch)	CCTTACGAGGAAAAAAAATTGCAAGTAATTTGATGATCATATTAGAGGTACTAGTTTGTAGTTTTACGGTCCTAAGTTAGTCTACACTATTTGATTAACTTGCGATCACTATTAGTCATAGACAAAGACGTATCAAAAGTAAGGCTCTCTCCCCAATACTTCCTCATTTA
synA5(+TATA+Inr+Ypatch)	CCTTACGAGGAAAAAAAATTGCAAGTAATTTGATGATCATATTAGAGGTACTAGTTTGTAGTTTTACGGTCCTAAGTTAGTCTACACTATTTGATTAACTTGCGATCACTATTAGTCATAGACAAAGACGTATATAAATAAAGGCTCTCTCCCCAATACTTCCTCATTTA
synZ5(WT)	AAGCGATTCACCCGTGAAATCGAATGCGCGCCTGAACTAGCCCATTCATGTCTACGTCTGACGTCACTTCACAATGCGGGGAGGTTGCTCTGAAAAGTTTAGACCAGATTGCCGATGATAGAACTGTCACGATGCTGGGACGTAACTCCGCAAGGGCAGGAAGATCCAGG
synZ5(+TATA)	AAGCGATTCACCCGTGAAATCGAATGCGCGCCTGAACTAGCCCATTCATGTCTACGTCTGACGTCACTTCACAATGCGGGGAGGTTGCTCTGAAAAGTTTAGACCAGATTGCCGATGATAGAACTGTCACGATATAAATACGTAACTCCGCAAGGGCAGGAAGATCCAGG
synZ5(+Inr)	AAGCGATTCACCCGTGAAATCGAATGCGCGCCTGAACTAGCCCATTCATGTCTACGTCTGACGTCACTTCACAATGCGGGGAGGTTGCTCTGAAAAGTTTAGACCAGATTGCCGATGATAGAACTGTCACGATGCTGGGACGTAACTCCGCAAGGGCAGCTTCTCACTCG
synZ5(+Ypatch)	AAGCGATTCACCCGTGAAATCGAATGCGCGCCTGAACTAGCCCATTCATGTCTACGTCTGACGTCACTTCACAATGCGGGGAGGTTGCTCTGAAAAGTTTAGACCAGATTGCCGATGATAGAACTGTCACGATGCTGGGACGTAACTCCCCCCCGGCAGGAAGATCCAGG
synZ5(+TATA+Inr)	AAGCGATTCACCCGTGAAATCGAATGCGCGCCTGAACTAGCCCATTCATGTCTACGTCTGACGTCACTTCACAATGCGGGGAGGTTGCTCTGAAAAGTTTAGACCAGATTGCCGATGATAGAACTGTCACGATATAAATACGTAACTCCGCAAGGGCAGCTTCTCACTCG
synZ5(+TATA+Ypatch)	AAGCGATTCACCCGTGAAATCGAATGCGCGCCTGAACTAGCCCATTCATGTCTACGTCTGACGTCACTTCACAATGCGGGGAGGTTGCTCTGAAAAGTTTAGACCAGATTGCCGATGATAGAACTGTCACGATATAAATACGTAACTCCCCCCCGGCAGGAAGATCCAGG
synZ5(+Inr+Ypatch)	AAGCGATTCACCCGTGAAATCGAATGCGCGCCTGAACTAGCCCATTCATGTCTACGTCTGACGTCACTTCACAATGCGGGGAGGTTGCTCTGAAAAGTTTAGACCAGATTGCCGATGATAGAACTGTCACGATGCTGGGACGTAACTCCCCCCCGGCAGCTTCTCACTCG
synZ5(+TATA+Inr+Ypatch)	AAGCGATTCACCCGTGAAATCGAATGCGCGCCTGAACTAGCCCATTCATGTCTACGTCTGACGTCACTTCACAATGCGGGGAGGTTGCTCTGAAAAGTTTAGACCAGATTGCCGATGATAGAACTGTCACGATATAAATACGTAACTCCCCCCCGGCAGCTTCTCACTCG
synA6(WT)	ACAAGTAATATGCAATACCAAGAACTACTGACCTGGTTGTTCTGATACTAATCAAAATAATATTGTTAACCAATGTAGATAGTAAATAATTTTAAGCACCATTATCCACGACATCTAAAACAATTAATAATTTTATGCTAACTCATTGTAACGACATATCAAGGACTCGC
synA6(+TATA)	ACAAGTAATATGCAATACCAAGAACTACTGACCTGGTTGTTCTGATACTAATCAAAATAATATTGTTAACCAATGTAGATAGTAAATAATTTTAAGCACCATTATCCACGACATCTAAAACAATTAATAATTTATAAATAACTCATTGTAACGACATATCAAGGACTCGC
synA6(+Inr)	ACAAGTAATATGCAATACCAAGAACTACTGACCTGGTTGTTCTGATACTAATCAAAATAATATTGTTAACCAATGTAGATAGTAAATAATTTTAAGCACCATTATCCACGACATCTAAAACAATTAATAATTTTATGCTAACTCATTGTAACGACATATCTTCTCATCCC
synA6(+Ypatch)	ACAAGTAATATGCAATACCAAGAACTACTGACCTGGTTGTTCTGATACTAATCAAAATAATATTGTTAACCAATGTAGATAGTAAATAATTTTAAGCACCATTATCCACGACATCTAAAACAATTAATAATTTTATGCTAACTCATTCTCCCCCCATATCAAGGACTCGC
synA6(+TATA+Inr)	ACAAGTAATATGCAATACCAAGAACTACTGACCTGGTTGTTCTGATACTAATCAAAATAATATTGTTAACCAATGTAGATAGTAAATAATTTTAAGCACCATTATCCACGACATCTAAAACAATTAATAATTTATAAATAACTCATTGTAACGACATATCTTCTCATCCC
synA6(+TATA+Ypatch)	ACAAGTAATATGCAATACCAAGAACTACTGACCTGGTTGTTCTGATACTAATCAAAATAATATTGTTAACCAATGTAGATAGTAAATAATTTTAAGCACCATTATCCACGACATCTAAAACAATTAATAATTTATAAATAACTCATTCTCCCCCCATATCAAGGACTCGC
synA6(+Inr+Ypatch)	ACAAGTAATATGCAATACCAAGAACTACTGACCTGGTTGTTCTGATACTAATCAAAATAATATTGTTAACCAATGTAGATAGTAAATAATTTTAAGCACCATTATCCACGACATCTAAAACAATTAATAATTTTATGCTAACTCATTCTCCCCCCATATCTTCTCATCCC
synA6(+TATA+Inr+Ypatch)	ACAAGTAATATGCAATACCAAGAACTACTGACCTGGTTGTTCTGATACTAATCAAAATAATATTGTTAACCAATGTAGATAGTAAATAATTTTAAGCACCATTATCCACGACATCTAAAACAATTAATAATTTATAAATAACTCATTCTCCCCCCATATCTTCTCATCCC
synZ6(WT)	TACATCAACCGAGGTCATCAGACGCAGTGACAATAGTTGTAATCGCAGCCTATTAGCGCGTTTGAATTTGAAAGTTTAACACCGAACACATAAATCTCGTTACAGCACCATCAGAGATCAGAGCAATCCCGGTGCCGAACCCGAATGCACAGTACAGCAACAGATATCCT
synZ6(+TATA)	TACATCAACCGAGGTCATCAGACGCAGTGACAATAGTTGTAATCGCAGCCTATTAGCGCGTTTGAATTTGAAAGTTTAACACCGAACACATAAATCTCGTTACAGCACCATCAGAGATCAGAGCAATCCCGGTATAAATACCGAATGCACAGTACAGCAACAGATATCCT
synZ6(+Inr)	TACATCAACCGAGGTCATCAGACGCAGTGACAATAGTTGTAATCGCAGCCTATTAGCGCGTTTGAATTTGAAAGTTTAACACCGAACACATAAATCTCGTTACAGCACCATCAGAGATCAGAGCAATCCCGGTGCCGAACCCGAATGCACAGTACAGCATCTCTCATCCT
synZ6(+Ypatch)	TACATCAACCGAGGTCATCAGACGCAGTGACAATAGTTGTAATCGCAGCCTATTAGCGCGTTTGAATTTGAAAGTTTAACACCGAACACATAAATCTCGTTACAGCACCATCAGAGATCAGAGCAATCCCGGTGCCGAACCCGAATCCCCCCTCCAGCAACAGATATCCT
synZ6(+TATA+Inr)	TACATCAACCGAGGTCATCAGACGCAGTGACAATAGTTGTAATCGCAGCCTATTAGCGCGTTTGAATTTGAAAGTTTAACACCGAACACATAAATCTCGTTACAGCACCATCAGAGATCAGAGCAATCCCGGTATAAATACCGAATGCACAGTACAGCATCTCTCATCCT
synZ6(+TATA+Ypatch)	TACATCAACCGAGGTCATCAGACGCAGTGACAATAGTTGTAATCGCAGCCTATTAGCGCGTTTGAATTTGAAAGTTTAACACCGAACACATAAATCTCGTTACAGCACCATCAGAGATCAGAGCAATCCCGGTATAAATACCGAATCCCCCCTCCAGCAACAGATATCCT
synZ6(+Inr+Ypatch)	TACATCAACCGAGGTCATCAGACGCAGTGACAATAGTTGTAATCGCAGCCTATTAGCGCGTTTGAATTTGAAAGTTTAACACCGAACACATAAATCTCGTTACAGCACCATCAGAGATCAGAGCAATCCCGGTGCCGAACCCGAATCCCCCCTCCAGCATCTCTCATCCT
synZ6(+TATA+Inr+Ypatch)	TACATCAACCGAGGTCATCAGACGCAGTGACAATAGTTGTAATCGCAGCCTATTAGCGCGTTTGAATTTGAAAGTTTAACACCGAACACATAAATCTCGTTACAGCACCATCAGAGATCAGAGCAATCCCGGTATAAATACCGAATCCCCCCTCCAGCATCTCTCATCCT
synA7(WT)	ACTTATTATCGTTGCAAAGAACTGGTGGGATTGATAAGATTTAATCAGTATGTTGTACCCGATATACCCCGCAATTGGGTAATGATGATATCTGTGACGGATATACCATCTGCATGTTACCTGGTAGTAGATATTCGTACGAGAAAGAAACCAAAAATGCTCAAGGTTAT
synA7(+TATA)	ACTTATTATCGTTGCAAAGAACTGGTGGGATTGATAAGATTTAATCAGTATGTTGTACCCGATATACCCCGCAATTGGGTAATGATGATATCTGTGACGGATATACCATCTGCATGTTACCTGGTAGTAGATTATAAATAGAGAAAGAAACCAAAAATGCTCAAGGTTAT
synA7(+Inr)	ACTTATTATCGTTGCAAAGAACTGGTGGGATTGATAAGATTTAATCAGTATGTTGTACCCGATATACCCCGCAATTGGGTAATGATGATATCTGTGACGGATATACCATCTGCATGTTACCTGGTAGTAGATATTCGTACGAGAAAGAAACCAAAAATGCTCTTCATTTT
synA7(+Ypatch)	ACTTATTATCGTTGCAAAGAACTGGTGGGATTGATAAGATTTAATCAGTATGTTGTACCCGATATACCCCGCAATTGGGTAATGATGATATCTGTGACGGATATACCATCTGCATGTTACCTGGTAGTAGATATTCGTACGAGAAACCCCCCCCAAATGCTCAAGGTTAT
synA7(+TATA+Inr)	ACTTATTATCGTTGCAAAGAACTGGTGGGATTGATAAGATTTAATCAGTATGTTGTACCCGATATACCCCGCAATTGGGTAATGATGATATCTGTGACGGATATACCATCTGCATGTTACCTGGTAGTAGATTATAAATAGAGAAAGAAACCAAAAATGCTCTTCATTTT
synA7(+TATA+Ypatch)	ACTTATTATCGTTGCAAAGAACTGGTGGGATTGATAAGATTTAATCAGTATGTTGTACCCGATATACCCCGCAATTGGGTAATGATGATATCTGTGACGGATATACCATCTGCATGTTACCTGGTAGTAGATTATAAATAGAGAAACCCCCCCCAAATGCTCAAGGTTAT
synA7(+Inr+Ypatch)	ACTTATTATCGTTGCAAAGAACTGGTGGGATTGATAAGATTTAATCAGTATGTTGTACCCGATATACCCCGCAATTGGGTAATGATGATATCTGTGACGGATATACCATCTGCATGTTACCTGGTAGTAGATATTCGTACGAGAAACCCCCCCCAAATGCTCTTCATTTT
synA7(+TATA+Inr+Ypatch)	ACTTATTATCGTTGCAAAGAACTGGTGGGATTGATAAGATTTAATCAGTATGTTGTACCCGATATACCCCGCAATTGGGTAATGATGATATCTGTGACGGATATACCATCTGCATGTTACCTGGTAGTAGATTATAAATAGAGAAACCCCCCCCAAATGCTCTTCATTTT
synZ7(WT)	AGCTACATTATTTCATTGAACACTACCTTACGCTTTGCAATGTTGTAAGTTAGAGGGGTGTGAGACGAAGTACTTCGGAGCTGGCTTGCACCGATTTTGCACATCAATGATGACAACCCATATGTTGCACTGTTCCGCGGCGCACGTGTGATATCCGGATATGTTTGAAT
synZ7(+TATA)	AGCTACATTATTTCATTGAACACTACCTTACGCTTTGCAATGTTGTAAGTTAGAGGGGTGTGAGACGAAGTACTTCGGAGCTGGCTTGCACCGATTTTGCACATCAATGATGACAACCCATATGTTGCACTGTATAAATACGCACGTGTGATATCCGGATATGTTTGAAT
synZ7(+Inr)	AGCTACATTATTTCATTGAACACTACCTTACGCTTTGCAATGTTGTAAGTTAGAGGGGTGTGAGACGAAGTACTTCGGAGCTGGCTTGCACCGATTTTGCACATCAATGATGACAACCCATATGTTGCACTGTTCCGCGGCGCACGTGTGATATCCGGATTTCTCACTTT
synZ7(+Ypatch)	AGCTACATTATTTCATTGAACACTACCTTACGCTTTGCAATGTTGTAAGTTAGAGGGGTGTGAGACGAAGTACTTCGGAGCTGGCTTGCACCGATTTTGCACATCAATGATGACAACCCATATGTTGCACTGTTCCGCGGCGCACGTCTCCTCTCCGGATATGTTTGAAT
synZ7(+TATA+Inr)	AGCTACATTATTTCATTGAACACTACCTTACGCTTTGCAATGTTGTAAGTTAGAGGGGTGTGAGACGAAGTACTTCGGAGCTGGCTTGCACCGATTTTGCACATCAATGATGACAACCCATATGTTGCACTGTATAAATACGCACGTGTGATATCCGGATTTCTCACTTT
synZ7(+TATA+Ypatch)	AGCTACATTATTTCATTGAACACTACCTTACGCTTTGCAATGTTGTAAGTTAGAGGGGTGTGAGACGAAGTACTTCGGAGCTGGCTTGCACCGATTTTGCACATCAATGATGACAACCCATATGTTGCACTGTATAAATACGCACGTCTCCTCTCCGGATATGTTTGAAT
synZ7(+Inr+Ypatch)	AGCTACATTATTTCATTGAACACTACCTTACGCTTTGCAATGTTGTAAGTTAGAGGGGTGTGAGACGAAGTACTTCGGAGCTGGCTTGCACCGATTTTGCACATCAATGATGACAACCCATATGTTGCACTGTTCCGCGGCGCACGTCTCCTCTCCGGATTTCTCACTTT
synZ7(+TATA+Inr+Ypatch)	AGCTACATTATTTCATTGAACACTACCTTACGCTTTGCAATGTTGTAAGTTAGAGGGGTGTGAGACGAAGTACTTCGGAGCTGGCTTGCACCGATTTTGCACATCAATGATGACAACCCATATGTTGCACTGTATAAATACGCACGTCTCCTCTCCGGATTTCTCACTTT
synA8(WT)	ATCTAGACACTGGCAATTATACGTAAGTTATCCAAAAAAGCTCGGAAATTCGACGATTCGTTATTTCATAGCTGGAAAAAGTCTTAAAAGTCCTATAACCAGAGATACAGGTACATCTAAGTCATTTATACGTTGGATTTAACACCTTGTAGCGTTTCTAATGTAGTTAC
synA8(+TATA)	ATCTAGACACTGGCAATTATACGTAAGTTATCCAAAAAAGCTCGGAAATTCGACGATTCGTTATTTCATAGCTGGAAAAAGTCTTAAAAGTCCTATAACCAGAGATACAGGTACATCTAAGTCATTTATACGTATAAATAAACACCTTGTAGCGTTTCTAATGTAGTTAC
synA8(+Inr)	ATCTAGACACTGGCAATTATACGTAAGTTATCCAAAAAAGCTCGGAAATTCGACGATTCGTTATTTCATAGCTGGAAAAAGTCTTAAAAGTCCTATAACCAGAGATACAGGTACATCTAAGTCATTTATACGTTGGATTTAACACCTTGTAGCGTTTCTTTTCTCATTTC
synA8(+Ypatch)	ATCTAGACACTGGCAATTATACGTAAGTTATCCAAAAAAGCTCGGAAATTCGACGATTCGTTATTTCATAGCTGGAAAAAGTCTTAAAAGTCCTATAACCAGAGATACAGGTACATCTAAGTCATTTATACGTTGGATTTAACACCTTCTCCCCTTTCTAATGTAGTTAC
synA8(+TATA+Inr)	ATCTAGACACTGGCAATTATACGTAAGTTATCCAAAAAAGCTCGGAAATTCGACGATTCGTTATTTCATAGCTGGAAAAAGTCTTAAAAGTCCTATAACCAGAGATACAGGTACATCTAAGTCATTTATACGTATAAATAAACACCTTGTAGCGTTTCTTTTCTCATTTC
synA8(+TATA+Ypatch)	ATCTAGACACTGGCAATTATACGTAAGTTATCCAAAAAAGCTCGGAAATTCGACGATTCGTTATTTCATAGCTGGAAAAAGTCTTAAAAGTCCTATAACCAGAGATACAGGTACATCTAAGTCATTTATACGTATAAATAAACACCTTCTCCCCTTTCTAATGTAGTTAC
synA8(+Inr+Ypatch)	ATCTAGACACTGGCAATTATACGTAAGTTATCCAAAAAAGCTCGGAAATTCGACGATTCGTTATTTCATAGCTGGAAAAAGTCTTAAAAGTCCTATAACCAGAGATACAGGTACATCTAAGTCATTTATACGTTGGATTTAACACCTTCTCCCCTTTCTTTTCTCATTTC
synA8(+TATA+Inr+Ypatch)	ATCTAGACACTGGCAATTATACGTAAGTTATCCAAAAAAGCTCGGAAATTCGACGATTCGTTATTTCATAGCTGGAAAAAGTCTTAAAAGTCCTATAACCAGAGATACAGGTACATCTAAGTCATTTATACGTATAAATAAACACCTTCTCCCCTTTCTTTTCTCATTTC
synZ8(WT)	CGTATAAGACACAGCATGCTGAGGGTCGCAGAAAGTTGATGGCTGGTGCCTTTGAACCTGCTGCCACCAACTTACAAAGCGGATACAGTTACGCATGATACGCGGGAACCTCGAGATACCCGGACAAACGTAAGTCCAGACCTCGATATTCCTGGCTAGCATACGCTCCA
synZ8(+TATA)	CGTATAAGACACAGCATGCTGAGGGTCGCAGAAAGTTGATGGCTGGTGCCTTTGAACCTGCTGCCACCAACTTACAAAGCGGATACAGTTACGCATGATACGCGGGAACCTCGAGATACCCGGACAAACGTATATAAATACCTCGATATTCCTGGCTAGCATACGCTCCA
synZ8(+Inr)	CGTATAAGACACAGCATGCTGAGGGTCGCAGAAAGTTGATGGCTGGTGCCTTTGAACCTGCTGCCACCAACTTACAAAGCGGATACAGTTACGCATGATACGCGGGAACCTCGAGATACCCGGACAAACGTAAGTCCAGACCTCGATATTCCTGGCTAGCTTTTCATCCA
synZ8(+Ypatch)	CGTATAAGACACAGCATGCTGAGGGTCGCAGAAAGTTGATGGCTGGTGCCTTTGAACCTGCTGCCACCAACTTACAAAGCGGATACAGTTACGCATGATACGCGGGAACCTCGAGATACCCGGACAAACGTAAGTCCAGACCTCGATCTTCCTCGCTAGCATACGCTCCA
synZ8(+TATA+Inr)	CGTATAAGACACAGCATGCTGAGGGTCGCAGAAAGTTGATGGCTGGTGCCTTTGAACCTGCTGCCACCAACTTACAAAGCGGATACAGTTACGCATGATACGCGGGAACCTCGAGATACCCGGACAAACGTATATAAATACCTCGATATTCCTGGCTAGCTTTTCATCCA
synZ8(+TATA+Ypatch)	CGTATAAGACACAGCATGCTGAGGGTCGCAGAAAGTTGATGGCTGGTGCCTTTGAACCTGCTGCCACCAACTTACAAAGCGGATACAGTTACGCATGATACGCGGGAACCTCGAGATACCCGGACAAACGTATATAAATACCTCGATCTTCCTCGCTAGCATACGCTCCA
synZ8(+Inr+Ypatch)	CGTATAAGACACAGCATGCTGAGGGTCGCAGAAAGTTGATGGCTGGTGCCTTTGAACCTGCTGCCACCAACTTACAAAGCGGATACAGTTACGCATGATACGCGGGAACCTCGAGATACCCGGACAAACGTAAGTCCAGACCTCGATCTTCCTCGCTAGCTTTTCATCCA
synZ8(+TATA+Inr+Ypatch)	CGTATAAGACACAGCATGCTGAGGGTCGCAGAAAGTTGATGGCTGGTGCCTTTGAACCTGCTGCCACCAACTTACAAAGCGGATACAGTTACGCATGATACGCGGGAACCTCGAGATACCCGGACAAACGTATATAAATACCTCGATCTTCCTCGCTAGCTTTTCATCCA
synA9(WT)	GATGGAAATTCAAAGATACTCCGGATCTTATTGAAGCAAGATAGTTATAAGGTTTTACTGTATTTTAATTATCATTAGGAACCGAACAGTCACAGATTCAAATGTATTGTTAGACAACTGGAAACAGAGGGTAGATACAGTTTATCACTAAGAATTGCTTCGAAACGGTA
synA9(+TATA)	GATGGAAATTCAAAGATACTCCGGATCTTATTGAAGCAAGATAGTTATAAGGTTTTACTGTATTTTAATTATCATTAGGAACCGAACAGTCACAGATTCAAATGTATTGTTAGACAACTGGAAACAGAGGGTTATAAATATTTATCACTAAGAATTGCTTCGAAACGGTA
synA9(+Inr)	GATGGAAATTCAAAGATACTCCGGATCTTATTGAAGCAAGATAGTTATAAGGTTTTACTGTATTTTAATTATCATTAGGAACCGAACAGTCACAGATTCAAATGTATTGTTAGACAACTGGAAACAGAGGGTAGATACAGTTTATCACTAAGAATTGCTTCCTTCACCTA
synA9(+Ypatch)	GATGGAAATTCAAAGATACTCCGGATCTTATTGAAGCAAGATAGTTATAAGGTTTTACTGTATTTTAATTATCATTAGGAACCGAACAGTCACAGATTCAAATGTATTGTTAGACAACTGGAAACAGAGGGTAGATACAGTTTATCCCTCCCCCTTGCTTCGAAACGGTA
synA9(+TATA+Inr)	GATGGAAATTCAAAGATACTCCGGATCTTATTGAAGCAAGATAGTTATAAGGTTTTACTGTATTTTAATTATCATTAGGAACCGAACAGTCACAGATTCAAATGTATTGTTAGACAACTGGAAACAGAGGGTTATAAATATTTATCACTAAGAATTGCTTCCTTCACCTA
synA9(+TATA+Ypatch)	GATGGAAATTCAAAGATACTCCGGATCTTATTGAAGCAAGATAGTTATAAGGTTTTACTGTATTTTAATTATCATTAGGAACCGAACAGTCACAGATTCAAATGTATTGTTAGACAACTGGAAACAGAGGGTTATAAATATTTATCCCTCCCCCTTGCTTCGAAACGGTA
synA9(+Inr+Ypatch)	GATGGAAATTCAAAGATACTCCGGATCTTATTGAAGCAAGATAGTTATAAGGTTTTACTGTATTTTAATTATCATTAGGAACCGAACAGTCACAGATTCAAATGTATTGTTAGACAACTGGAAACAGAGGGTAGATACAGTTTATCCCTCCCCCTTGCTTCCTTCACCTA
synA9(+TATA+Inr+Ypatch)	GATGGAAATTCAAAGATACTCCGGATCTTATTGAAGCAAGATAGTTATAAGGTTTTACTGTATTTTAATTATCATTAGGAACCGAACAGTCACAGATTCAAATGTATTGTTAGACAACTGGAAACAGAGGGTTATAAATATTTATCCCTCCCCCTTGCTTCCTTCACCTA
synZ9(WT)	TAAGCTCAGGTTTGCCATATACTACCAAAATATGCGCTCTACATCTGGAAAAGGGATATCAGTCGATTACTCAGTAGGACGGTTAGTAAGTTTACAGGGTTAGGGCAACTTGCGGGCTTACTCATTCAATATAGTCTGCTACTACGCACCGCGCATGATCCTGTGCGCCC
synZ9(+TATA)	TAAGCTCAGGTTTGCCATATACTACCAAAATATGCGCTCTACATCTGGAAAAGGGATATCAGTCGATTACTCAGTAGGACGGTTAGTAAGTTTACAGGGTTAGGGCAACTTGCGGGCTTACTCATTCAATATTATAAATAACTACGCACCGCGCATGATCCTGTGCGCCC
synZ9(+Inr)	TAAGCTCAGGTTTGCCATATACTACCAAAATATGCGCTCTACATCTGGAAAAGGGATATCAGTCGATTACTCAGTAGGACGGTTAGTAAGTTTACAGGGTTAGGGCAACTTGCGGGCTTACTCATTCAATATAGTCTGCTACTACGCACCGCGCATGATCCTCTCACCCC
synZ9(+Ypatch)	TAAGCTCAGGTTTGCCATATACTACCAAAATATGCGCTCTACATCTGGAAAAGGGATATCAGTCGATTACTCAGTAGGACGGTTAGTAAGTTTACAGGGTTAGGGCAACTTGCGGGCTTACTCATTCAATATAGTCTGCTACTACGCCCCCCCCATGATCCTGTGCGCCC
synZ9(+TATA+Inr)	TAAGCTCAGGTTTGCCATATACTACCAAAATATGCGCTCTACATCTGGAAAAGGGATATCAGTCGATTACTCAGTAGGACGGTTAGTAAGTTTACAGGGTTAGGGCAACTTGCGGGCTTACTCATTCAATATTATAAATAACTACGCACCGCGCATGATCCTCTCACCCC
synZ9(+TATA+Ypatch)	TAAGCTCAGGTTTGCCATATACTACCAAAATATGCGCTCTACATCTGGAAAAGGGATATCAGTCGATTACTCAGTAGGACGGTTAGTAAGTTTACAGGGTTAGGGCAACTTGCGGGCTTACTCATTCAATATTATAAATAACTACGCCCCCCCCATGATCCTGTGCGCCC
synZ9(+Inr+Ypatch)	TAAGCTCAGGTTTGCCATATACTACCAAAATATGCGCTCTACATCTGGAAAAGGGATATCAGTCGATTACTCAGTAGGACGGTTAGTAAGTTTACAGGGTTAGGGCAACTTGCGGGCTTACTCATTCAATATAGTCTGCTACTACGCCCCCCCCATGATCCTCTCACCCC
synZ9(+TATA+Inr+Ypatch)	TAAGCTCAGGTTTGCCATATACTACCAAAATATGCGCTCTACATCTGGAAAAGGGATATCAGTCGATTACTCAGTAGGACGGTTAGTAAGTTTACAGGGTTAGGGCAACTTGCGGGCTTACTCATTCAATATTATAAATAACTACGCCCCCCCCATGATCCTCTCACCCC
synA10(WT)	CAGATCGATAATGTTCAGTGTATCCAACTATGGAATTATAGACAGTAGTTGCATTCTGATCAAACATAGTATATTATACCTTGTGATTGCTAGTGCGAATTCATGCAGACTGAATAGGAGAAGTCAGTATTCGAACTGATATTGTTAAATTTAAGTATATGGTATATAGT
synA10(+TATA)	CAGATCGATAATGTTCAGTGTATCCAACTATGGAATTATAGACAGTAGTTGCATTCTGATCAAACATAGTATATTATACCTTGTGATTGCTAGTGCGAATTCATGCAGACTGAATAGGAGAAGTCAGTATTCTATAAATAATTGTTAAATTTAAGTATATGGTATATAGT
synA10(+Inr)	CAGATCGATAATGTTCAGTGTATCCAACTATGGAATTATAGACAGTAGTTGCATTCTGATCAAACATAGTATATTATACCTTGTGATTGCTAGTGCGAATTCATGCAGACTGAATAGGAGAAGTCAGTATTCGAACTGATATTGTTAAATTTAAGTATATCCTTCATTCT
synA10(+Ypatch)	CAGATCGATAATGTTCAGTGTATCCAACTATGGAATTATAGACAGTAGTTGCATTCTGATCAAACATAGTATATTATACCTTGTGATTGCTAGTGCGAATTCATGCAGACTGAATAGGAGAAGTCAGTATTCGAACTGATATTGTTCCCTTTCCGTATATGGTATATAGT
synA10(+TATA+Inr)	CAGATCGATAATGTTCAGTGTATCCAACTATGGAATTATAGACAGTAGTTGCATTCTGATCAAACATAGTATATTATACCTTGTGATTGCTAGTGCGAATTCATGCAGACTGAATAGGAGAAGTCAGTATTCTATAAATAATTGTTAAATTTAAGTATATCCTTCATTCT
synA10(+TATA+Ypatch)	CAGATCGATAATGTTCAGTGTATCCAACTATGGAATTATAGACAGTAGTTGCATTCTGATCAAACATAGTATATTATACCTTGTGATTGCTAGTGCGAATTCATGCAGACTGAATAGGAGAAGTCAGTATTCTATAAATAATTGTTCCCTTTCCGTATATGGTATATAGT
synA10(+Inr+Ypatch)	CAGATCGATAATGTTCAGTGTATCCAACTATGGAATTATAGACAGTAGTTGCATTCTGATCAAACATAGTATATTATACCTTGTGATTGCTAGTGCGAATTCATGCAGACTGAATAGGAGAAGTCAGTATTCGAACTGATATTGTTCCCTTTCCGTATATCCTTCATTCT
synA10(+TATA+Inr+Ypatch)	CAGATCGATAATGTTCAGTGTATCCAACTATGGAATTATAGACAGTAGTTGCATTCTGATCAAACATAGTATATTATACCTTGTGATTGCTAGTGCGAATTCATGCAGACTGAATAGGAGAAGTCAGTATTCTATAAATAATTGTTCCCTTTCCGTATATCCTTCATTCT
synZ10(WT)	CAGGGGCAATATGGATTCTCAAAACCCTGTGCTGATCAGGGGGCGGCGAATCTGTACTATGAGGCGGTCTGCCTAAGCCTCATGGCCTTAGTCTGTTACTACTGCACAATTCGTGTAATTGATCGAAAGTGGAAGAGATAATACGCGCCTACCGCTGTGCAGTTACTTAC
synZ10(+TATA)	CAGGGGCAATATGGATTCTCAAAACCCTGTGCTGATCAGGGGGCGGCGAATCTGTACTATGAGGCGGTCTGCCTAAGCCTCATGGCCTTAGTCTGTTACTACTGCACAATTCGTGTAATTGATCGAAAGTGGTATAAATAATACGCGCCTACCGCTGTGCAGTTACTTAC
synZ10(+Inr)	CAGGGGCAATATGGATTCTCAAAACCCTGTGCTGATCAGGGGGCGGCGAATCTGTACTATGAGGCGGTCTGCCTAAGCCTCATGGCCTTAGTCTGTTACTACTGCACAATTCGTGTAATTGATCGAAAGTGGAAGAGATAATACGCGCCTACCGCTGTGCTCTTCATTTC
synZ10(+Ypatch)	CAGGGGCAATATGGATTCTCAAAACCCTGTGCTGATCAGGGGGCGGCGAATCTGTACTATGAGGCGGTCTGCCTAAGCCTCATGGCCTTAGTCTGTTACTACTGCACAATTCGTGTAATTGATCGAAAGTGGAAGAGATAATACGCCCCTCCCCCTGTGCAGTTACTTAC
synZ10(+TATA+Inr)	CAGGGGCAATATGGATTCTCAAAACCCTGTGCTGATCAGGGGGCGGCGAATCTGTACTATGAGGCGGTCTGCCTAAGCCTCATGGCCTTAGTCTGTTACTACTGCACAATTCGTGTAATTGATCGAAAGTGGTATAAATAATACGCGCCTACCGCTGTGCTCTTCATTTC
synZ10(+TATA+Ypatch)	CAGGGGCAATATGGATTCTCAAAACCCTGTGCTGATCAGGGGGCGGCGAATCTGTACTATGAGGCGGTCTGCCTAAGCCTCATGGCCTTAGTCTGTTACTACTGCACAATTCGTGTAATTGATCGAAAGTGGTATAAATAATACGCCCCTCCCCCTGTGCAGTTACTTAC
synZ10(+Inr+Ypatch)	CAGGGGCAATATGGATTCTCAAAACCCTGTGCTGATCAGGGGGCGGCGAATCTGTACTATGAGGCGGTCTGCCTAAGCCTCATGGCCTTAGTCTGTTACTACTGCACAATTCGTGTAATTGATCGAAAGTGGAAGAGATAATACGCCCCTCCCCCTGTGCTCTTCATTTC
synZ10(+TATA+Inr+Ypatch)	CAGGGGCAATATGGATTCTCAAAACCCTGTGCTGATCAGGGGGCGGCGAATCTGTACTATGAGGCGGTCTGCCTAAGCCTCATGGCCTTAGTCTGTTACTACTGCACAATTCGTGTAATTGATCGAAAGTGGTATAAATAATACGCCCCTCCCCCTGTGCTCTTCATTTC
AT1G02250	TCAACAGTTAAGATATGCTTTAAATCCCTTTGTTGGACTTGCTCTTATGATATAAACTTGTAGACGAGCGGGCGAAGAGCGACCATAGAGAAAGCTCTCTACTTCATATTTTGATATCTTTCCCTCTCTTAGTTTTGATCTGAACCTTTTTGTAGCTGTTGAAAAATGGC
AT1G05100	ACATATTTTGTTGGTAATCACATCGAAGATTCGAAATTGGATCACATTTGGTAATCAACTTTTTTTTCCAAAGTCTCCACGTGTATGGACGATTACATACGTACACTTATTTATTTTCGCTTTGGTGGATAAACTCGATGTTACCAAAAGTATACACTATCTAATTACCG
AT1G10430	ATTAAAAACTTAAAAGCAAATTTGTCAAATCTAAAACATAATATGAAAACATTAGTTGACTAATTATAATTACCGGATGAGAGGAGGAGATGATTTGTCCATATATACTTATCGTTTAGACAAGTTCAAATGACAATAGCTCTGCTCCAACTACCCACGTGTAACGGTTC
AT1G10450	CTAACTCTGCTTTTTACTTGGTTTTTGATTTACATAATATTAAACCGGTAAGTTTGATTTGGAATTGAAAAATAAACCAATTTCGTACGTAACCTTCCATTTAGCTCCGAAGGTTCTGATTACATACAGACATGAAGATTTCTTTGGGTATATAAGCAAAACAAGCTCCT
AT1G28030	TGTTGAAATGTGATCTTTGACTGGGGTTGTCATGTTTGGTCTTTTGGGCCGAAATCTATGTGAACACGTGGTGAACACTTGGACTATATATGTGAACACTTGGTCTTTCTCCTCTTAGGTTTCTCCTCCTAATCTTCAAATCTTTACACAACGCCATCTAAAGATATGGC
AT1G34390	ATTAAATTTAGTATTCAAATCTAAGAAAGTATTTTAATACTTCTTACCTATAAATGTGATATTCTGTGCTCTCATGGTCGCGAGAGAAGTTGAGGAAAGAGAGAAAGTTGTATAATAATTGTTGGGATAACATATTTTGGTATACCGATCTTTAGATACGAGCTTATGGA
AT1G65350	AGATTTGGACAATCCTACATTCAATGTTTTAGTAACCGCGCAAGAAGTGAGGTCATCTAGAACAAAAGACAGAAATGTTGGACCTCAACTTTTTGCTATGAGTAGGCTGATTACAATATCCAGAAGGAATCAACACTCCATTTGGTTCTCAGGTTAAGAGGTGGTATGCA
AT1G66160	ATTTTTCCCGTGATATGTTTTTTTTTTCTTTTACCTAAAAATTAACTTTGACCCACTCGCGTTCGAGAAGCGTATGATAACGACTAATTTAAAATGCATACATTTTATTATCTCTATATTCACATCCATACATATATAAATCTCTCATCCCCACTTGTGTTCTCCATTAG
AT1G74860	GAGAGATTACGAAAAGAGTGACGGAGATAACGGGAAACCGTACCGCCGTTTGCAGTCTGAAATGCTGAAGCTGACGTGACGTGTGGTGTGGCGTTTGAGAAATAACATCGAGTTTTTAGGGGTAAATAGGTCTTTATACTTCTTTCTGTTCCTAACAGACAGACGCTTCA
AT1G78760	CCTTCATATTTGATTTCTTCATGCTGCTTCGCGACATCGCAGGTACAGATTTATTTCCTTAGGTTCCTTGTGTAATTCAATAGATATTTTGTATGATTCTAGCGAAATTTTTCTATCAAATGTTGAGTATTTCTATCTGATTTGACATCTGTGATGCAGATTAACATGGA
AT1G79310	TAAAATTAAGTTTAATAATTAATTACGAAATGTTGTATCAGCTCGCCGTCTTAGCTCAGTGGTAGAGCGCGTGGCTTTTAACCACGTGGCCGTGGGTTCGATCCCCACAGACGGCGATTTGTTTTATGTTTTTTGATAATTAGTCCACAATTTTCACGTGCCATCATTTA
AT1G79800	AAGAAGTGGCCCATGACTTGCAGCACGAAGGAGAATGAATGAATTAAATAAAAACCGTTTCAAATTCATCTCCACGACTCCTCGGCCTCGGAGAGCTCAACCGCCACTTTCCTTCTCCTTGTTTATATAAAGCAGAGCCAGCCACCTTCATTTTTACACACAACCATCAA
AT2G05580	CCTACGTGTTGCCTCCAGAGACTTGAACGAAGCTTGCAGACATATTTCCTGCTGCCAACTAAGTTGTTTCTGGTCATGATGTGCCCTCAAGATGCTTCACCACTTGGGTTTTCTTTAATATTTACCATTTCTTAGATGCTTACTCTTTGAGAGTAAGGTGCAAGTATAAA
AT2G16660	ATCTCTCTGTATCTAAATTTTTCCGGATACTAAAAAATTGCAGAATTGATCGGAATTAAGTAATACTAGATCTAACCGTATATACCAGAAGATGCATCAATTCCCAAGTTGGCCACATACAATTATTTCAAACGACCGGAACAAAAAAAAGAAAAAGACCAAACCATTAG
AT2G24560	TCAAATGAAATGTGAAACCTGATCTCCAAGACTCCATTTTTCAGCAACTTCTGGGGCCAAGTTTTTGTATCAGACGCATCCCAATATGATAAGTTTCACTTCCCAAGTATTTGGTCTTTTCTAGCATATATATTGGATTTATCTAAAGAAAACTATACACTAAAAATGGT
AT2G26020	CTTGTCCAAGTCAGATTAACCAGCCGCCCATGCAAAGCCAAAGCAGCCGCTTAGGTTACATTAGATATTGAGAGAGAAAAATATGTGGTAGATAAACAAGCCATCAACTATTAATAAGCCAAGATCTTATCTTTTAATATTAGCTCGAGAAGGCGTACGTGGTGTGTTTA
AT2G35345	TTTTAACTATTAAGTCGTATCAATCTCAGTTGATTGTTGTAGTAAAATCTCAATATCGTGTAATTTGTTTATTTTTTGTATACCGTTTCACTACGCATAAAGTATATTGTTTAACTTATCTAGAGCCGGACAGCATGCTGTTTTCTAACTAACTAAAAACGGCTTTTTTA
AT2G39670	TGCAGTTAACACAAATCTTATAAATTTGAAATGTCGTTCAAACTCCAAACCACAAAAAGGGGAAGCAAAACGCAACCGTTTCACGATTTTTGTCTAGTTTGGTCCAATTTCTCAATTACGGTTTTGTGAAATGCGTGTCGGTCTTTGGTTCTGCATTCGAACTGTGTGGC
AT2G45580	TTGAATCCAATTAATGACACTAATACAACTCACTATTTTACATATTATGTTCTCATTGTTTATATAATTAGTCTGTACCAAAAAGAAATCCCATGTTTGTAAGAAATTTAGGCAAGTATGTAAGGTTCAAACTTTCCATAAGTGGGCATGACAAAAACAAATTTTTAGAA
AT2G46870	GTGGCAAATGAATAATATGGGGAAATATTTAAAGAATTATAATTATGTAAGGAAATAAAAGAAAAATAAGAGAAACTAGGATAGTGGTAAAAGGACAATAAGGTCACATGAACTGAACCAGATTTATTCATGGGTCCCTCTAAATTGGTTCTCTTGCCCATATCTCTCCA
AT3G01090	AAAAAAAGTTTATGTCAATGTATCTCTCTAAACCGGTTTAAGACGGTACAAACTTTTTGAAAGATGCCAAAACAAAACGGTGGTTAATAATTTTACCACAGAGAATATTTAGCAAAAAGATGATGACTAGATGCCACGTCCGCATGGGGGTATATATTGTAATTAGTCGT
AT3G13480	ATACGTAACTAATTTTTTTTAACAAAACACATAATCTTCTCAATAATTATCTAACAGATAAAAAATATTAGAAAATAAATATATATGATATCCTAACAACAAACAGAATCCAATATATAAGATTAAGCGAGGGAACAGTTAATCTAATTAGTTAAAAAAAGACTTCACCT
AT3G15251	CAAGAGACGGCCGTTGAAAAAGAGATGATCGGCGGGAGAATTCTCTGAGAAAGAGTCTTGCGACGGAGAAGTTGGAGTCAACGATCCGAACTCAAACTCCGGTGGTGGCTCGTCGGAGTTTGTTGTTACTCGATGATTCTCCATTTCTTTTGGTGTGTTTGATTTATGCG
AT3G25880	AGGGAGTCCAAAAAAAGAGCGGGCATTGCGGGTTGGGTGCGTTTGGAACTTTGGATTGTGGATTAGTCATGGTTTATCTATTAATGTCTGCGGACTTGTGGACGACGCGCTTGTTCTTCTTCCTCTGTTTACGACTTACGAACATATGATCTCTCATCTCTAACAATGAT
AT3G26090	TGGGTGGGTTTGTGAAATCTCTCAATAGTATAGGGTGGTTATGTCAAAAATCTATAATAGAGGGTGGTTATTGTAATTTTAATGTACCAACTTGTCACAAAGGACAAGTATGAAAAATCTATAATTATAGAAGTGAAAAGTGAAAAACCAATCAGAATTGTTACCGGAAA
AT3G26235	TAATATGTGTTAATGGTTGACTCTGTAGACTCAAGTACATCATGAAGTATGCTTCTAACATCTTGCGACTAGTATAATTTCAAAATATTTGAAGTTTTTGGCGGACTACAACTCAAAGCTTATTGAATCAAGTAAATATATAACAACACGGTAAGCTATTAAGGTATGGT
AT3G46200	ATCTATTACTAGATGTATACCACCACCTGCAAACGGGAACCTACCACCATCCATCTCCTATATATATATAATCTATTATGTACGCGCACTACATCTTCCTTCCTAATCCATACATGCACGCACCCATATATATAAATGACTCATGCATGAATGATGAATCATATCATAAT
AT3G55540	GCCTCTTTCCTCTCTCTCTCTCTCTTCCGGTGATTCCTTTAGCCTATAGATCAGCGGTTGATCTCAACAGAGAGATAAGTTTGTTTTTAAGAGATTTTGATATCTAGCTAGGGTTTACTTTGGATATTTCTTCGTCTCCCCTAGGGCATAATTACTGGTGCAGATATGGA
AT4G13710	TTAGAATTAGGGGAACGGAAGGGATCCGAGGATCTCAACATATCAACGGCTAAGATTGTAAGATCAAAAAGTAGCAACAAACATATTCCGTTAAGTAGCGGCGTGTGTTAACGTTAACGTTACTTTATTGCGTATATATAAACGGAGACGGTTTCCTTGGAGCTTGTGCA
AT4G14276	TCAAGGTTGGAATCCAATCTTTTTGGAAACATGTTTTTAATTTGGTTGACTAAATATATTGTATTCCTTACTAATTTATTATGTAAGATAATGTTAATTCGAAGGATCCCTTGAATATAGTTACAATTCTTACTATAAATACGAAACAACTCCTCCTTCATTCTCATTGC
AT4G14710	CTCTCGACTCGAGTCTTACTTTGACACCACCAAACTTCTCTTCTTTTGTCCATTTTTAACCCAGTTTTTAACTTTTAACTTTGTTAACTTTTTTACAATAATTACCACTCTAACTAACGTATTTACATTTTCTCAAACCTCAAAAATGTGATAAATAGTCTGAAACGGAT
AT4G24415	GCATAAATATCAGGTTTATATCTGCATATCTTTGTAATTGTATGCTGTTCGTTGTTTTTATAATATGAATTTTAAATCTGAAAATTCATCTTCCCTTGTTAATGCAGTGGAAAACTGCTACAGTTGACTGAGATAAGGTTCTGACAGTCCAGCTGAGATGCTGAGTATCA
AT4G31170	CCATGAAAGTATTGCTCTGAAGCTGTCCCAATTAATAAAAAAATTAGGGTTAAAATGTGTATTGCTCGGAATGGTAGAGCGCGTGTGAGACACTTTCTATCGGAGAGAGTATTGCTCGGAAGCTGTCCCAATTAATAAAAAAACGAATTTGCCAGCAAAGGACGGACCAA
AT4G35450	TGAAGTGACGCGTGTTTATCCATTAACGGATAATTTGATCTTAAATCACAAATCTTACGTGGCTGATCTTATTATTCAAACGCATGGGCTTGGGCCTTGAGGTAAACAGGTTTATATGGGCCAATAACAATAAATTTGATTAAAAATAAAAGGCCTCTTAGCTTTAGGTT
AT5G01755	AATAACAATATATTTCTAGTGGACGTGTGTGAGTAGGTCCACATGGAAATTTTACAAGAACTTGACGTGTGTTTAAACAGACAATTTTGGTCGAGTCCCTTCTTATATGAATGTGAACCAGCACCCTACGGATAGACGGACACGACAATGGCAAGTATCATGTTCGTTGA
AT5G02420	CATATATTTGTAAGTGTTTAAAAAAAATAATTTGTAACTGTAAAGTATGTTTTGTATATAGTTTTAGATCATATATTTGATTTTCATTAGACAGGTCTTTTTCTAGTTTACTGCTAAATATTAATTTACATAGATAATTTATTTTACTTTTTTTTGGACATCAATTTAGA
AT5G04010	TCCAAATATTTCCTATTTTTTGAATTATAGATTAAGTCTCACTTTATTGTTTTAACTTTTAACGCGTTTCCTAATAGGATTCGACATTGGTCATCAACATCTTCATACCGCTATAAATACACATGTTCAGTTCCAAGCTTTAGAAGAAGAAAAATAAAACAAGTACTGAA
AT5G04475	GAAATTATGGAACCTTTAATGAAACGTCCAATTATTGATCATCTTCGTGAACAAGAACGGAAACTTCTTCGCCGCTTGGCCACCGTGATAGCCGTCGTGGTGGATGACGCCATCGTTTGGTTGTAAACAGAGGAGAAGAACCGCTCGATCTCATCTTTGTTGACGATGAT
AT5G08590	AACCCTAATTTTGTTGGCTGAAAGTTGAGGTTTTTACACTTGGGAAGTGAAGAAGATTAGATCTGTTGGAAAGATGGAGTCTTGCGAATATATATCTATAGAAGATTTTGACTCTAGATCTGTTACGACCAAATTAGTCAAATGGTTTGTAGTATTTAAGAGAGAGCCCA
AT5G11840	ATTTGGTTATATTAGGAGAGAACCAGCAAATTCTTATTCAATTTTTTTTTGTCTTTCATCATGATTACTCCAAAGGGTTTTTCTTTGTGAAGAAGATTTTATTTCTCATCAAATTTGTGTATAAAACGAGAAAGGGTGTATTTGTTGTAAGCAAAAAGTTATGGGGTAGA
AT5G20500	CAAAATTGATGTGACACAAATATTAATTTTAGGTTTTGGGATGATGTATGATTTTCTTAGTTTAGCGGAAATCAAATTGAACCCGCAAGATAGTGTTAAGACGTCTAATACCAGCTTTGGTCATGTCATTATCATTATCATCCTTTATACTCCAAAAATGTTCTATGTTT
AT5G22760	CGACGACGACGGCGTACGAAATCTGCCGGACCCGAGAAACGCGCGTAAATTAGCGACGAGTCTCTCAAATTCCCGCCATTATATTGTTTTTTTTATTCAAGTGATGAAAATAGAAAGGTAAATTCAAAAACGGTGACGTTTTAAAATCCCTAACGGGTCTAGATCCGGGT
AT5G37950	TTAATGAGAAACGGTTTTTTAAATGAAAAACTAAAAGGACACACTGTCAAAATTTTAAGCTTTTTATAGTATTATATATATTTTGTATTTAAACTTGTTATGTATTAAATTGATTAAATGTTGAAATATTAGTGTATATATTAAATGTTATACTAATAAAGTTTTGTAGA
AT5G58250	AGCATCTCAGCTCCGCCTCCGTCGCCATGAAAGTCACAGTTAACGCCTTTCCCTTTTCTTTCTTACGGGCTTGAAGAAACCCATAACACCTTATTGGGCCATTACTGAAGCCCAAATAACATTAAAATCAATTAAAAATTGAGTTGAGAAAGGGAGAGAGAGAGTGATGA
Zm00001d003823	CAGCTAGCTGCCCCGGTTCCGGAGATCGCCATTGAATGTCCCACCCACATTTTCCACCTCGCATTTACTCCGCCCCCCGTCACCGGAGCGCTATATCTAGGGCGGCAGCGCGGCACTGACTTCTCCAACCAACTCATGCTCGACAGACCACCTCGTCGGGGCTTCGCATT
Zm00001d004661	ACAACTGATCCAAAATGAAGGCGGAAAAAGGAAACCAATCATGCCTGACAAAACAGTCTCTAGAACTTCCCCGGCTGAAAAAAAAGAACTCTCCTGCGCAGCGCGCACTCAACCGGTAAGCAGAGAGAAAGCTCCAAAATCCTTAAACACGCATAAAACCCACCTCCAAT
Zm00001d005092	ATGCTGATCTTGTAAAATGTGCAGCGAGTTTGACGACCCACCCACTCACACGCCGAACCGACGCCGACAGCTGCCGCCTGCCGGACCCAACAACAATCAACAAAGCCTACAAAATCACAACTCCACGTTCGTCGCCGCGGGAGGATCGGGCTGGGCTGGCCTCGCCTCGG
Zm00001d007822	ATAAGTTAATAGAGCAGAGATAGATAGAAAATAAAATGATAAATGTTTTTGATGCCTTTTGTGTTTTGTTCTTCCTTTTGTTCTTTCTTTATTCGTACTTTTTTTTCTCTAAGTCGTCATCGTACGGGAAACGTGGAAGCGCAGTGCTCCTCTTCTTTCCTTCCCCTTCC
Zm00001d010988	AACTGAAGAAAACCAAGGCAAGCGCTAACGATAGATATACCTTGACAAGCTAGTATCAAACAAAACCAGTAAAAAAAGTTTACTTTCTTGTCGAATTTCATTGCCTACCTGATGTACGTACTTGTGCTTCTGCACAAAATAACGAAATCCTTTTGCCCTCTGATGATGAT
Zm00001d011461	GGGAGTACTAAACAAGCTGCAATAATTCAGCGCGCCTTTATTCTTGCAATAATTCTAGGACCTGGCTGAATGCTGCGTGCGAGGTCGGCCGCGCGCCTATAAAACACCTCGTCCCGTGCCTCCATCAGGCATCCAAGCTCAAAGCAAGCAGATCTAAGCTCCAGGCAGCG
Zm00001d011747	GCAAGCATCGATCTGCCGGTATCTCTAAGCTTGAGCCAGCCCAGAGCCGGCCGCCGGAATCTACTACTCTCTGACGACTCGACGCGTTAGCTAGCTCGTCGTTGGCTACAAATTGCGCTGCTCTTCAGGGGCTTGTATTGCCATGACCATTATTCACTAGGGAATGTCAT
Zm00001d011895	ACTTGGGGTGTGTGAATTATTTTTGGCGCGCAACTCCGAAATTTTCCTCCAAACTTGCTTCCTTCCTCTGGAAGGAGGAGGCGCCGTTTTGGCTTCCCGAGCAAGCGTTTTGCTTCGCAAGGAAGCCCCCCCACCCCACCAATCTCCGCCGTCGCATTGGCACCCCACCG
Zm00001d013232	GCGGCTCCCAAATTAAAACCCTTGAAAAGTGGAGGCGTGTTCAAGTGCGTATGAATCCGAACACAGAGAGACAGACAGAGCTCCCGCAGAAGGCTACAAAGGCGCGAAACTTCGTTGACCCAAAACAGAGAACCCCAACCGCCGGTACCAATCTTCGTTCTCCCCTTTCT
Zm00001d013304	AAAGACTAATTTGCAGTTGCAGGGGACAGGACAACACAATCCGTCGGGCGGTCGGGCCTGTTCGAGTTTTGCAGCATTGGCAGGGGCGGCCCAGTACAAGCGAGCGAATAGGCCCAGCCGCGTCTCCGCCTCCACTCCGCCAGCCGCCAGCCAGTAGCCGCGTGCCCGCG
Zm00001d013721	AACCATGCAATTGTCTCAAATAGTTATGGCCCAACCTAATGGAAACATATTTTCACCAGAACTATGGGCTGATTTCCATGGGCCCAAGGCCCAGTACTGTATTTTTTTTTCTAAAATTCTAAGCCGCAAAAATCCGGCTCCACAATCCCGCTGTTCGCGAGCCACTCCCT
Zm00001d014590	TGTGTTCCGTCTCGCGCCGACCCATCTGAGCTGGGACACGCAGCGACAATTTACTCGTCGGTCCAGGGACCCCCCAGGGTCGAAACACCGACAAAACTACTACTATATTTTCCTCTTTTAGTGGAAGGGCTTGTTAAGTGATATACATCAAATGCTGAATCAGGATCTGA
Zm00001d014668	ATCTATATGGTCGCAAGAGAAATTTGATTGCACAATCGTTTTTACCAAGTAAAAAAAATCTTTTTATATATATAGGTGCAAAACCTCTTCTCGGCTTCGAGGGAGTCAAGCAGAAGCAGAAGCGCTGAAGCAGCGCGTTTGCAGACTGCAAAGACCCCTGTGAATTTGTG
Zm00001d015070;Zm00001d015072;Zm00001d015075	ATCTCCGATCCATGCACGTCGTTCATAAGGTGGCCCGGCCGGCCTATCTATAAATACCATCAAGATCAATGGCAGATGCATTCCTGTATCCAACTAGCTCATTTAGTAGGGGATCAGCTGTAGAGTCCGGATCGGATAGTGAGGAAGTGAACGGAGGGAAAGAGAATGAG
Zm00001d017477	ATGACAGACTCACCAACTTTGTCGCTACCCGGTGCTGGTGTGGTGCCTGGTGGGTGTACACCGTAGCTGTATTACTGTAGTGGTGGAGGTGGCGTTTAGCAGCACACAAGCTTGAGTTGAGCGCTCGAGCTATTTATGCCCGGTAACCGGAAGCGCTCTCCTCCGCACAG
Zm00001d018633	GGGCCGCCACCACTAGTGATGGCCCATCACCGCCGCCGCCTCCTCCACTCTCCCTCCATCCATTTACCACCCCACCCCGCCGCCGCCCTCCTCTTCTCTCCCCTGAGCCTGACTGGAACCTTCCCGAGAGAGGATACAAAGGCACCCGGATCGAGGAAACCAATCCATTC
Zm00001d019582	GCGGGGGAGATGGCAGATTCGCGCACCTTATCGCCGCCCGCCAAAGAAACCTCCTGCGCGTCGCCCGGACCCGCCGACCCGCCTGCCCGCCTGGTGCTCGACCTAATGCCGCGGCGCCCCCCGGCATCCAATCTTTATATGAAGGCTAGTTTTTATATGAAGGAGCACCG
Zm00001d020843	AAGTTGTTTAGCCACCACGATGTATATTTTGATTAGGCCAAATCTTATTTTGATTAGGCCAAATCTGTGTCAACGACCCTCACTCCCTCGGTTGAAACCCAAGTCTCGCACACTTTGCATTGGGGCTTTGTCTGACTGCTACAATCACGCTAGGCCGCATACGCCATGGA
Zm00001d021588	GAATATAGGAGAGTGAATCTTGCTGACGTGACTATATAGTAACATTTAGGGGAAAAAATTTAAAGGACACTACTGCATACAGTCTAAAGTAGTAGGGGAAATATTTGGGTCCTGACGAGTGGGCACTGGCCACTTAGCTGCGGGGCGATTCTTTTTCAAATTTTTTGGGT
Zm00001d022327	ACAGACAGGGCACGCACGCGCCGCCATACCGACAGTTCCGTCTCAAACTCTCTACCTGCTCCGCTGCCCACACGGCACACGAGCTGTCAGCTATATACTCCATCGCACGTCCAACCCCAGGGAAACACCCATCCAAGATACCGACGAGCAGGCCAGAGCGAAGGAATGGA
Zm00001d022343	CGGTTCAAGTGATAGGAGGGGATTAATTCAATCCCTACCTGGATTAAATCCCTCCCTAGATTGAACCGAACATGGCCTCAGCGTCCGCCGCTGCCAGCCCCACCTCCCGTATCCGGCATCCCCGTGCAGCCCCACGTCCCGCGCAGCTCCGCTCCTCTGGCAAGGCAATG
Zm00001d023315	CTCGAAACCCTAAACTGCTCTGCGCATGCGCGGACCGTCCGGCCCACAGGCGCGGACTGTCCGGACCGCAGACCGTCCGCCAGGCTCAAAACGGTGCTCGACAGAAAGGAATTCAGCCAGTCGCGGCCTATAAGGGGAGTGCTAGTCCAGGTTTAGGATTTCACCATGTT
Zm00001d023473	AGCACCCATTTTTTATCACTGCTTGTGTATGGTTTACACTTAATATACTAAGGTCAGAACTATGAACTATTTCAATCCAAGTATAATTCATTAATATTTATTCTATGATACTTCCACAACACTGTTTGTGTTGATATCCCTGAGCCCTGAAAACCAAAGCTTATTGGTTT
Zm00001d025118	ATAATGACTTATATTTTAGGACCGAGGGAGTAAATTTCAATTATTTTTCAATATAAAAAGAAAAAAAAAGATAACATTTGATCGGGTTAACATTGAGAGCCAGTTTAGTGACCAGGTATGATAGAATCGCTGGTTATCAAATCAGCAATCAGAATGGGCCTACTACGGAA
Zm00001d026125	AGGCGTCCAGGCAGGTAGCCGAGTTTCTTAATTTCTTTGATGTTTGATCTAGCTAGGTGCCTAGGTAAAATAATAAATTAGATAATTACCATTTACCAGCTGTCAATTATGTTTATTTGGGGCATTGTGATTATGTAATTTTGCATCTACTTAATTTCAGCCAAGATGAA
Zm00001d026163	ATCTAATTAATAATCGCCCTCACATGCACTCATGCTCACGGGAATGTAAACTCACACAACAACACTGCTATTACAATAATCGGCACTGCGCCGATGGTTCTCCTATAAATGCAACAATCAAGCGCCACCACGAACCATCACAAGCGCTTAGTGATCAGTTAATACTAAGG
Zm00001d027449	GGCCGAAGTTCCGCGCCTCTGGACGGGGGCCTGGCGTGTATCGTGGTGCGTTGCCTCCCGCGCCACCACTACTCCGTCTCCAAGTCGCGTCGTCGCACTCGAATCCATCCATCCATCGATCGCCTTCCTCTCTTTTTATATCGCACCCCCCCGCTTCCGCTCGCTCGATC
Zm00001d027759	CTTTGCAATACATACGTCTTGCAAGAGCTGAGCTAAGCTGAGCTGAGAGACGGCTTGCATTTGGTGTTGTGTGCCTAGCTAGCTACATATATTCTGTAGCTAATAAGCTAAGCTTTAGCTCATTGGTGGGGTGCTTGTATTGGCTTGTTGCACCGGCCGGCCGCCATGCA
Zm00001d028798	CAAGTTGTTTAACATGTCCATCTAGCTAGCTTACCTTCTTAGCTTGCGCTCTATAAAAATCAGTGCCACCCAGCCATGCCGAACAGCCAGCAAGGGGCAGGCAGGAAGAGCAGAGTTGTCACTTATCACCAACGAACTGCATAGCCTAGAAACTTGAGGGGATAGATGGG
Zm00001d029207	TGCATGCGTCCGGTTATTTTAGAAAAAACTGAATAAACCTGTCTGCACGAAGGATATAGAGAGAATGCTAGTAGTAGTAGGCACTATTACTCTATAAATAAGCAAGCATTTGACCTTGACCCGCACCAGGACTGGACTAGTCGTGAGACTCGTGGCGCGAAGGCAATGCA
Zm00001d030346	CAGCATAAAGCAACGCCAGAGGAACCGCTTTATTCTTCTGATTCATGGACCAAGCAAAGGTAACCTCTTGTCAGTTGTCTCCCACTGCAGTACCCTCTCCAATCTATAAATTTCTTCACAATATCTTCTGCACCTCTCACACAAGACATCCTTACATTTTCTTGCTGATC
Zm00001d030574	ATGGATCCATCAACCAATTTCTAAATCGATGATATTTGATTGTTTGATTTTGGTGTAGACTCTCGATTTAAACAATTTCAAGTGTCTGTAGAATGTAGTTTGGATGTGAACTGAAGTAGTGATAGTTGCTACTGACCTTCATAATTTTTGCAAATGGTCTGGGATAGTTT
Zm00001d031136	CGTCCCGTGCACCAGCCATCCCCGTGAGGCCCTCACCTGCAGTGACACGGTCCACCTTGGACCAGGCGCCCCGAGCTGTTCCTCTGCGACAGCAACCTTGCGTGCATAAAGCCAGCCACCAGCCAGGCAGCCGCCATCTCCAGCGGCTTCTTCCAAAGCTCCAACTCCGA
Zm00001d033098	TACCACTACCAGTGGGCAGTGGCAGCATGTTGCATGGCATCATCCAGTCCAGACTCCAGAGCCTCCCTGTCGTTGCCACCTCCCCACCACACACGTCCAACCCCGCACCCAGTCCAGATACCCATCCACTGGATCCTTATATACGCCGGCGGCCTAAGACACCGCCAGCA
Zm00001d033817	TATAACAAAACTTCTATTGCGATTTTTATCCAATTTTTTTATTGCTAAATCAAGTAGGGTAAATTTTGATCGAGCAGTCCCTTGAACCCCAGTCAACCTGGCACTGGCAGCCCTCCCCAACCTTGCCCGCGTCTGCACAGTCCTTGGCCGCCGCAGCACACACCGCACTC
Zm00001d034130	CTCGCGCGTCCAAATCGGACGACAGCGCCGATCGAAAAGCCCCGGATCGCACGCGCATCTCTCCCTTGTCCCCCACGGCCCCACTCCCCCTTCCCACGCCCACGCGCCGGCGCCGCTACCGCCTCGCCTATAAAAGGTCCCGGCCGTGCCCGGCCTCGGTTAATTCAGGC
Zm00001d035466	ATACCTGAAATACAACCTCTAAATGTTTGCTTGGACAAATTAAAATCATATATAACCTAAGTGTGCAAGCATGATTCTGTAGCGAAATCAGTGAAGCCTTACTTTATTAATATCAAAAGGTTTTATTCAATTTGCTATTAGTCAATAACTCTTATTTTCCTGCAGGTAAA
Zm00001d036588	TTCAGCTATCAGTACTTGTTCGTACCGTTCTGTACCTGCAAACAGTGATGCATATTGCAGCATAGCTACTGGTATATATACACACGCATCCGACGAAACAAAAGCATCAAGCTTTCCTGCTTGAGTGCTTGGCCTATAATATATAGCTCCATCGATACGGTTTTGCATAA
Zm00001d038151	GCCACGCCAACCGTCTCTGCCGAGCCGCCGTCGACTTCCTGCCTCAGATAAAAGGTTGATCCTTGTGTGCGTGCCGCTGATACGACTCCCGACCGGGTCCATTTCGGCGGCACGCCCCGCCGCGTTCCCCACCGCGCTATATTGCGTGCCGCTGATACGAGTCCACATCG
Zm00001d038911	CCCTAGTGGCGCATACTCCTGCACTCGTGGTTCTGGACAAGTCAATCTGCGTTGCACACTTGTCCTGCACTAGCAGCGGGACTGTCTGCCGCCATGCAATTGCCATTGCAGCTCCCACCTCGACGACGTGCCTATAAATGCCGCCGGTGTCTCTCCGACCGGTCGCACCA
Zm00001d039310	CCTTCACTTTCCACAAGCCAAAACTGTCACGACCTCATCCAATCATCTACACAATTCTATCTTCCGGCGGCCACTTGTGATTTGATCATCCTTCTATGTCCCTGCCCCTACCCCAGTCTCTCTGCTGGCTTCTCATTGACATGGACGTCTCAGCGTTCCTTGCACTGCTG
Zm00001d040652	GAAATGAACTAATTTCCCTTTGAAAAATGAAAATCAATTAGAAAATGAGGTTCCCAAACTAAGCCTTAGAAAAATAAATATTGTCGATATTTTTTTAGCAACCCGATTAAATTTAATAATGTTTAACTGATAGATAGATATAAGCAAGAGCGAAGAGCTTCCCGGGCTTG
Zm00001d041497	CACAATACAGATTTTTCTAATAATTAAAAGATATAAAGGGAAGAAATAAATCTACCTTTTTTTACTGTCTCCGAGAAGATCTCTCTCTGCTGTTCTTCCTTCCCCATAAACCAAAAGAGAGGGGAAAAAAGAAGAAAGAAAGCAAGGAGCACCGCACCACTCCACTCCAC
Zm00001d041700	AAACTATAAAATTCATGTAAAAATAAGTTATTGAGTCCATCTAGGCTTCTGGCCGTGACACGCCCGACGTCAGGTCGATTTTTAGTTAGTTTTGAAAAGTTACGCATCTTATTTCACTGCCAGCCCTCTGAAAAAAAATTAAAAAATGAGGTCCCAGTTCCACACTTCCA
Zm00001d041889	GCAGTGCAGCACGCGGCCTCGGTCCCCCACCCGAGGAGCCGCCACGCACCCCCTGGGTCCCCTCCACCGCCCGCCGGCGTTCCCACTTCAATTCGCCCAGCGCCCCTTTCTCCTCCCGAAAGGCAGGGCAACCCTACAAAACGCTGTCTCGGCTTCGCCGTCCAGCGGAA
Zm00001d043942	GATCATTAGGATTGTGACAAGCTTACGGCCTTGTCGAAAACAAGGGAAGCCCAATCACAATTTGTGCAACAAATGGGCCAGGACGACGACAATAAGGGCCCACTAGGGTTTATTTCCAAACCAGGCGCCTATAAACACTTCTCTCACGCTCACGGCCGCCGCCTCCACCC
Zm00001d044875	ACGCGTATGGACGCACGCACCCCAACTGCCCCCAACTCACTGCCCACTGGCTCCGCCCGCGTCCGCGCAACTTCTCCAGGTCCCGCCTCCTGCGCCAATCGCCATACATATATAGGACAACGCCACCCGCACGGCACGGCCAGACCACGCCGCACCACCGCCAGCTCCCG
Zm00001d045203	CAGATCTAATCTCATCTCATTCCCATCTCATTCTCATCTGCCTGCCCCCCACTGCCGCCGACTGCGCTGCGCCGTCCGGATCGACCGGTCCCCGCGCGCAACCCACCCCGCATGCGCGCCGGCCACTGCACGTATATATATACCCATCGTCGTCATCAATCTATCGCTGT
Zm00001d048760	CTGCCAGGTACTTTAATTTTGTTGCTCCTTGTCCCAATCCCAACACACGAACACATCACACACGACACGACACGGCACGCCCATGTTGATGCATCTATAAAGTGTACGTACGTCCTCTCCAATCCTGGCATCAAGAATCTGTAGGTACAAGTACAACAAGCGCGCGGTAA
Zm00001d050038	ATGGACTACGACGAGGAGTCCTCGCGTGCCTCCCCCTTGACACAGGTCCTCCTCGCATCTTGCTTTTTTGGCTCACTCGGTTGGTCGTTAGGGTTTTGTATCTCCGATTTGGTTGCTGCTGTGTTGCCTCACCCCGATGTGTGATGACGGTGGTTGTCACCGTGGATGCT
Zm00001d051294	TATTAGCATGATTATCGGGTGTCCACACTCTAGTAGAGCGTGTGGTATGACAGGCCAGGTAACCTTTTACGTGTGCGTGGCTATGAAAAACTAGCTAGTTTAGTGCATCAGTGCATAGCACTGGCATGTTTAATTTGCTGATGAAACTTGTACTGAATCTATGTCATGTT
Zm00001d053197	AAATCTATTCTAAATTTTTTAACAGCTAATCTAGTTTAAAAAGCGGACCAAGCGTACGCTAAGTTTTGAGATCGAAAGGGCAGCTGTAGATAGCATAAAGCCCAGCCCAAGTATCCAGCCTCACGACCGACTCCCTCAATTACCTGCCCGTCCCAATTGTTTCCGCAAGT
Zm00001d053831	CAGAAGATATCCCTGGATTGTTACCCTGAACTAAGTTCTAACAATCTGAGATCTATGATTCTATAAATGCAACTAATTAAAACCCCAGTGGGTCAGGGGGCAAACCTCAACAACCGGTCCTCTTCATCCTCCTCGAGCAGCACCCGCTCCATCTTCAAAAGCCGAATGGT
Zm00001d053976	CAAAATTGTGAAAATAAGCTGTTTGCTCTGTAGTTTTTGTTTCATTCTTGTAAAATTTCTGGGTTCCAAAAGGGGCCCTGACTCTGTCTGGCCAGCTGGTTTGGCTGGGAACTAGGCACTGGGTAGTGGGCACTGTCGTGTGCCCACGCACAGTCACACGGACATGTTAA
ENSRNA049996849	TTCCTCCTCCTGCTCCAAGTACGGCCGCCGCCGGCCGGTCACCGGATCCAAGAAGAACGGCCGATGGATGGAGGATTCGGTGACGAACTGCATGCTCCATGTTTTGATTGTGTGTGTTTATTGCTCGTACGTACTGTATACTGTATTAAGTTGCAGCGGCCGATTCGATT
SORBI_3001G048300	TTGTTTTTATTCTCTCTTTGTTTTTGGCCCAGCAATCGCTGGCGGCCCAGCCCAGGTTGACTCCCTCTCCTCTCCTTCCCGCGCGCATCTGGCCCAACTGGCCTGCTCCTCGAGCCCGCGCGCGCCCTCTCTGTTTTGGGCCTTGGCCCAACGCAGCAGTAGCAGCCGAG
SORBI_3001G132900	AGCCCAGCGCCCCAGCCCCAGGCCACAGGCCAGAGCCAAATCGAGCCTGTGTGCTTTACGATTCGTGCGTGACCATCCGGCGACCCGATCGCCTGATTTGCCCTACCCGGCTCGTCTCCTTCCCTGTCCCATAAATCCGACGCGCCGACGCCTCGATTCGTCGCCTCCCC
SORBI_3001G187000	GATTCTTGGAATGACTTATAATTTGGGACGGAGGGAGTATATATAGAGAGAGAGAGCGCGCTCCCAACACTCTGGCACTCTGTTCAGCGCCAGCGATCTGCACGTGGCAGCAGCAAGATACCGCGTGGGGGAGCAAGAGCAAGAGCAAGAGGAGTCAACGCACGAATGGC
SORBI_3001G233800	AGATGGTATGCGCACGCGTAGCAACTGGAACGCGCCAGGCATCTCGAGATGTGGCCGTAGCGCCAACGCCACATGAAGCTAGCTAGCGCACGGCGCACCCGCGGAAAAGGCCAGACCCGAAATAAAAAGGGAACGGAGGCGACCGAATCGGACGCAAGCTGCTAAGCCCA
SORBI_3001G298900	GTCATCATTTTTTATAATTATTTTATGTTTCGTCTCAACGCACGATGATATTTGCTAGCTAAAAGCCTCTAGTGTGAAACGCGCAAGTCACAACCACCCGGTCCAGTGCGTCGCCTACTGGTGTGCCTGGTGCGCGGGCCGGGTGCATCCTGCACAGCCGAACCACAAAA
SORBI_3001G320400	TCTTTTGCTCGATCGCAGATCGCACCACGCCGACGTCTCCATGAAACCACTCATGTCAGTGTCTGTGCAACGACAGTCCACTTCCATGAGTCTCCGTCCTCGTCCTCGTCCTTGTCTATATAAACCAGCCCCTACCTCAGACACGCACACACACACACACACAACTTCAA
SORBI_3001G329600	ATCTTCATCATCAGACGACCTAAAAGTGAGGGTCGTTTTTGTGACAAGATTGATATATAGTAGTTGCTAGAATTAATAATTCCTCTCTGGAATTAATTATCGTGCTTGTCTCCTTCACCACCTATGTCGTCTTACTAGTAGGCATTTTAAATACATTTTTTTTTTCCAAC
SORBI_3001G403900	AGAGATTAAAAAGCGTGGCTTTACACATTCTGAAACTAATTGTGACTCTTGGCTTGCCTGCAGTTACTGCCACCTTCTATAAGTACAGTCTCAGGCTACATATTATAACTATCGAAATATCTTAACCTTCGTTCATCGTCCTAAGTTTTACTCTTACTGGAGCACATGGC
SORBI_3002G037000	TTTTCCACTCAAAACATATATATAGCAAATCCACCACATCAAATAGAGTGGAGTGTCAACAAACTCTGGTACAACAGTTAGGCCTCTATATATGGAGTAATTAAGTAGCCGCAGCTAGCTGCAGATCAAATCTTAATTTGACGCGGGCAGTCCGGCAGTGCCTGCATGGA
SORBI_3002G054800	TATACATAGCGTCACGATAAAACCCATAACAACTTTGTAGCACAGCTAACTTTGTTTTCAGTTAGCCTTTTCCGTTCCCTTCCAAACAAATTTACTTGTCCTATTTGCCATGGTCACATTGAACACAGCAGGCTACTTGGTTCACAATGAGTGCAAGGGCAATGCACTAC
SORBI_3002G166400	GAATTATCAATGGATAGGTCCAAGCACAGAGTATCTATCGCTTTCACATATTAAGTCCCTGTGATGTGATCACATTCAACTTTTTTAATTGGTTTGGATTTGAAGCTTCTTCCTTCTCCTCCTCAAGTCACCATATAAACCAATCAGCTCCCATCCCAGGCCACACACAC
SORBI_3002G215700	TACATTAGTGAAATCTGAATTTTTTTTCGAACTAAACAAGGCCCAAGACACAGAACGTGCACACGCAAAGCTGGCGTTCAATGATACGTATAATGATAAAATTATATTTGTTGTATTTTTTAAACCTACAAACACGCCACGCCCATGCCCACGCCCACGCTTTCGTCTCG
SORBI_3002G366700	CTGCGGGACAAGTCAGCCCGAGCTGAAATCTTGGGCTGGGCCCAGGTCTGCATGCTGCCGGCGGCCTGCCACAACAAGTCTGGTGATTGGGCCCACCTCTCAACCCAAAGGAACCCTCTCTCTCTCCCGTTGGCGGTGCGACGAGGTGACCACGGCGCCGGAAGAATGGC
SORBI_3002G400000	TTGCCTGCCGAGGCTGGCAAGCTGCATGCAACGCGAACGTCGCCCACAGACCGCGGTGCACGAGTCGGTGAGTGCAGGCGCGTCCAACCTCCTCTCGTCTCCGGGCCAAGTCGGCAAGTCCGCGACGGCGAGCCGTATATTACCCACCCAAGCCCAACCAGGACCAAACG
SORBI_3003G017700	CATCGCCCTGCCGGTGCGTACGCGTTCCCCTCCCTCAGTCTGTCACCATGCCGTCAGTCTCGGCCCTGTCACGCACGCTCTCAGATTGCTTCGCCCTCCTCTCTTGCATTTGCTGCCTCGCCGTCTGGCGCTGATGGTCAGTCGATAAATTTGTGTCCTGTAGGGAGGAA
SORBI_3003G164600	TCGACGGATATTAGTTGACACGCAAGAAAATATTATATCCACACGTGCAAACCCGGCTTACCCGTTGTACCAACAGCCCATATTCTTGTTTCCGGCCCATCAAAGACCAACTCACAAGTCACATATAAAAGCAACTAAACCTAAGTGCTCAGCGTATCTCTACTCCCCAC
SORBI_3003G214650	GTTGTCACAACTTGGCCCAAGTGTTCTTACACTTCATTCACCCACTCAAGTTAATCAAGATTAGGATAGACAATGTAGTGCATCCTTGTAAAGTTTATGCCGTAGAGCTTGAGTGATTGAACTTTGTTGCCCTTTTGTATCTTGGTGATCCGGAGCCTTAAGGCCTTAGA
SORBI_3003G347520	GGTGCACACGGCCCCACCAACCCGATATCTCGCGGCGGGTGGGGACAGCCATGCGGGCCGCCGATCTCGTATCCGACGGCTTGCGAGCCGTCGCCAGATAGATCGCCGTGGCAGCGTGGCGCCTCAACGGCTATAACTGGGAGAGAGAGGACGCGCATGTTACCCGCCAT
SORBI_3004G049100	TATGGTTTGATGTAACAGAAAATCTTAAAAAGTTTTTAATTTTTGGTGAACCTGAGCAGAACAAAGCTGGGTGAGAAATGAGGAAGGGCGGTGTGAACGGCAGCAGGCGAGAGAAAAATGGAGGCGAGGCGCGCAGGCCCGCGGGAATGGTGTGGCCGGCGTGGGCTTGT
SORBI_3004G070200	ACATATATATATATGTATATATTCATAAGTGGCCTAAGCTTTTCTTAGTACTGCACATACATTAGCGTAGATTCAAAAAGAAAAATCTTGTAGAAAAGTGATAAGAGATATTTTGGGCCCAATCCAAATCTCGAACGACAAGGCTCCTGTCGTCCAGCCTCGCACAGTTC
SORBI_3004G184000	CCCTCCGTTCTAAATTATAAGATATTTTTATATTTTTACCTACAATAACTTTTTCAATACATTTAAATATGGAAAAGATAAAATATCCTATAACTTGAACACGGAGAAACTACCATTTAAATAGCGGTTAAGCCATAGCGCCAGGAGAGAAAAGCCCATAAAGCCTAACA
SORBI_3004G200200	GAAATTCACGGGCAGGCCCCTGGACCCCGGGAAAGCGAGCGGTGGTTCCGTCACTGACGTGCGGGGCCCTGCGCAAGCCGCACCGCCTAGAGAGCTAGAGGGTATCTCTTCGCGTGGAAGCAAACGAGGCGTGATAAAGAGGGGCTCCGGTGTCCCGGCGTTGCCCGCAT
SORBI_3004G219400	GCCCTAGAGCTGCAAGGTGCTCACAGCCAACACGCTTGCGTGCAGCGCAGCTACTGGTAAGGGACGAACTCAGGTGGGCCGGCCATTTCCGCACAGAAACGGCCTGCGACACTGCCCAGTTTCTCACAGGCCCGCCAACGGGTACGCAATTCACTTCTGCTTCGGCCCAT
SORBI_3004G248600	ATGACATACGGTTATAGCCGAAGATGAAGTTGAGCACAGCGGTACGAAACAACTTTTTAGTGGCAGATAAAAAGGCTCAAGACAAGAAGGTTGCTCCTCGCTTTTGTAGCCGGAGCCCGGAGCCCGGAGCCCGGAGCCTTTCTTCTGGATGGCCCACTTGGCAGCCCAAT
SORBI_3005G010500	AATATTGAAAACTTTTTGGTTTTCGGGGTGAACTAAACAAGGCCTAAACAGGGCCTAGATTGTGGGCTGTTTTCTATGGATGAAAATTCTAGTCGGTGGAACAAACAACCGGGCCTAATAAAATAAGCCCAAAAAAAGCGTGAGGGTCACCAGCCCATTTCAGTCCAACA
SORBI_3005G090900	GCACTACGGAGCTGGAAAAATACGAGGTCCCAAACACCCCCTAAGTCTGACTATTTATTAGCAATACAGAAACACAAGAGAAGGAAGCGGGAAAAAAAAAGTGTCAGGCTGCCCGCCTCCTAGGTGATGGGCCGTCCTGGGCCTTTCCGCGCCCTTTGTTGGGCTGGATT
SORBI_3005G096450	TTTAAATTTTGTTATATTTAAACAAAAATAATATCAGTATTTATTTCGTCATATAGATTAACTATAGAAGATACTGTTTTATTATAATTAACAATACTTGATTTTATAAAATGAATATCTTCTATATATTAATCTAATTATTAGCTAAAATTGTTTGAGTAGCGAGCAGA
SORBI_3005G155100	TTTATAGCTAAATAAAGGAAAAAAAGAGAGAACGGGCCGATAGGTCAAATTATTCCGGGCTGGGCCAGCGCCAAGTGACGACCTCAGAAGCCCGGCCCACCCTTTCTCGCTTTCCACCGTCGCTCGTCCTGCGGCCCATCCGTTCACCAGAGTCCGCCGGAGCAGCGAGG
SORBI_3005G186200	CCACGGAACATGGGAAAAGCATGTCAGGAAAGTGAGAAAGCCCTATCACAGCTGACGGCTTATGACTTAGAAACAGAGAAATTAACAAGTGGTACGCTTTAAAAACGTGAAGCACAGCAAACTGAGCCAAAACTAGTAGTAGTCATTTTCACCGTTCATACTCTGTTATG
SORBI_3005G228250	GAACATTAGGAAGGTGGCGTCTATCGATTAGTATGCCAAATAGACAAAACTCACTTCCCGAACGACTTAATCAAATGGAGATTGTGACTTAAGACTTAGAATTAGATGAGGAGTAGATGGGTATATATATGGTTTTTGTAACCACCATATATTCCAGCTTTCTTCGTGCA
SORBI_3006G120100	GCACCGTTGAGGTAGTCGTGTGTTTATTTAAACTTGCTGTCAAGTGCTTCTCATCAGCCATAGCTAAACGAATGGCTGCATATGAACAGAGGTAACTTACGGTGGACTGAACCATGTGCCGCACACAAATTGATAACACGCCTTTGTTTCCCTGTATTCACAGAATCAAC
SORBI_3006G136400	CCCGTCACCGCCAGGCCTAGCGCACGCCGACAGGGGTCCCCCGGACGCCAGCCCTCGTAGGCAAAACCTTGCACGCAGTCACGAAACTGCCCTCATCACTCCGCAGCGAACTACGATACAGCCCCTGCAGCCCTAGCTCCACCAGATAAAACCCCACCTCCTCCCGTCGC
SORBI_3006G211100	CGAAAGTTGAGAGATACTCTTCCCGCCCGCTACAAAAGCGCGGGATCTCTGCAGCTGCGGTCCACGTGCTCCTGCGCACTCACGAAAATGATAAACCCTCCAGGCCCAAGCCCAAACGAAAAGCCAACGCCTGGGACCTCTGCAGCCCGGCCCAGCCGAAGCACGCTGTG
SORBI_3006G250500	AGATAACCCCGGCCGGCCGGCGCCGTAGAAAGCGGGGGATGCTTGCCGGTCGGTTGGAGTAGCTAGATGATTGGTCATCCGACCGCAGTCCGACCAAACTACTCTTATTTTATATACATGTATCCCCCGCCCATCTCTCTTCCATCACATGACTCCATTTATCCCACATG
SORBI_3007G047000	TTATTAACTTGGAATCAAGTTACACTGATCTAGAAAACCGAGCAAACAATATAGCAGCAACAAAGGACATAATGGCCAGAATTAATTCTTTGCCATGTTTGCATAGGCCACCTACCTCTATATAAGCATGGCCATTGAGCATTGCATTTCAAATAATCAATCTTGCTTCC
SORBI_3007G094801	TTTTGGACCTGCACAACTTTTTCTATATAAATTCAAACATAAATTAAATTTGCACATAAAAGAAAAAGGAAAAAGGCATTGTGCTGTAGGCGGCCCAGCAACTTAGCCCGTAGGCCACCACACGCGCGCGTGCCACCTCTCCCTTTCTCTCTCCCCTAGACACTGATGGG
SORBI_3007G122932	GACTGAGGGAGATGCACACCCACCGGAGCATCACAATCGATCAATCTTGCGTCCTTTGACACCCAGCCAAACCTTCCCCTCCAACCGCCACTGCTTCTGCCCGACCGCCGGGGACTGCATCCGACAGGTGGAGAAGTTACAGTGTGGAAGAAAAGGTTCCCGACCATGGC
SORBI_3007G206250	TACTCGTCGCGTGTCAACTCAACCGCACCACGCCACGCACTTTCGGTATACCAACACCAAACCGCTCCTGCAAATCGCAACGGATTCACTTATCACGTAGGCAGCAGCGCGTGGACTATATATCGTATCAATCCGGAGCAGCGTCGACGGCACAGTGGTTGTGGTGGTTA
SORBI_3008G003600	AAACGGTTGTACGCCAAAGAACACTTTTCGGTCATTCATCCCTTGAACCGGTAAATCTCACGCAAGTGACGGTGCCACGGAAACAGGATACGCTGAGGCACGGAGGCAGCGGCGTAGGCGCGACTCTCTCCCTGCGCCGCCGGGGGTGGGGGCGAGAAGGGAGATCCGAC
SORBI_3008G032800	GATGTGACGGGGAATCTTGAAAAATTTTGGAAACTAAACAAGGCCTCACATGCATGCTGAAGCGTCCCCTGGTCTGGACCTCCCAGCAAAGTACTTGCTGACAAGGATTGAGTGCCTCTCTATTTAAATCCCTGCGGCCTCTTTCGCTGCCCAGTCTTTTGAGCACAAGC
SORBI_3008G072400	GCAGTTGCTGTCCTGAACACCTTTCATATGCTTCCAGAATGTTGCACAAATTACTAATGATAATATGTTTTGCTTTCACAGGGATAAGGGAATATCAGCAGAAAAATGAATGCTAATACGTGGGTGTAACAATGCACCAATTCTCGCAAGCATCTAAGACGACACTAGCT
SORBI_3008G120066	AAAAGAAATTAAATTTCAGTTCATATAATTTATGATTATAATAATGCAATCACTCAAGCCTATTTTTATCCTATGGTTGTGTTAAAGGAAAATAGAAGGGCGGTTTGGCTACAAACTCCTCATTGTCCTCTAACACACTAATGGAATGATGATGGAGTAATAAATGTTAT
SORBI_3009G108500	TATCATAGATGTTGTTACTTTTTTTTATAAAATTAGAAATTAATTCTTTCGTGGACGGAGGGAGCATGAGCATGGAGAAAACCAAGCTCACACGTACTTATGGGTTTTGGTGCCTCCCATAACCGCCGGCTGGTAAAAAAGCCAGCTAATCTTCACCACCATGTTTACCC
SORBI_3009G141300	GACGTGACACTAAAAAATTTTAATCTCAAATAACCTGAGCGTCCGAGACGGCCTGGCCCACATTTGACGAACGAGCGAGGTGGGGTGAAAACAGTTCACCGTGCCGGCGTGACCGCGTGCCACCATGGCCGCTGCTCGCTGCAGTCGCGTGCGCGCTCCCCGAGAGCCAC
SORBI_3009G189800	TTGTGGTTCGGTGCAATCCAAAGCAAAACCAGCGGCGCAGTTAGTGACAAAAGCCCACAGCCACAGCCGCCACATAATAATACAATTAATAGGTAACAGTTCTCAACATCCTTTCATCACGGCATCTGTTTGAGACATACATGAACAAAGCACATGTAATTCCGTATGAT
SORBI_3009G198100	AGTGAAAGGGTGGTGTTTCTTCCCCGCAATTTCCTCAAAGAAACTTAGGTAAGCATAGGTAGTTATAATAAAATGATCTGTTAATAACATTTACACAAAGAGAAAGAAAAGGAAGGGGAAAAGTAGAAAACGTCCTCTTTTTTCGCAAACCAACTCTCAAAGGGCGAATC
SORBI_3009G203900	CAGTTTTATCCCGCCATCGCCAGAGAGCAGTCAGCAAGCAGCCCCCGAAACATGGCGAAGTCCAAGGCGGAGCGAGGAGACGAACGTGTGGCTCGCCGCAGCGAGGCGGGGATCCGGTCCCCCGTCCCCTTCTCTATTTAGCCACCGGTCCCGTGCATGCTGCTAGAAGT
SORBI_3009G234600	CTCAGCCAGAGCTGCCTCATCTCCCTGAGGCTCCCGTCGCGCCAAGTGTTCCAGCATCCCGGACGCACCAATGGCATCCAGGCAACAGATTTTTCTGCAACTCTTGGCGACGTTCAAGATAGAACTGGTCGCGGCGGTGTTTCCCTCCCTCGCTTTAAATACCATCGTCG
SORBI_3010G016300	CATCTAGCTAAGCAAGCAAGCAATCAGCTACAGACCTACTATACAGTGAGCCATTTCGTCGTTTCTTTCTGCTGCCCGAATTAAAAAAGGTTGCGATCGATCGAGCCAAAGCTCTGAAAGTTAATTAATCAATTCAATTTAGCCGGAATTATGTATGAGAAGTGGGGGCT
SORBI_3010G035300	ACAACAGCAACATGTTGCACACGTTGAAGTCCACATAAATCTCAGTTGCCTACTCGCCTGTGCCTTTTTTTCTCTTTTTCTGTCTCCAAGTCATGGAAGGGTGCGGCGATATTTGACATATCAGATGTTGACCGTCTAACATAGGTTAGCACTGGGTTATGACTTCTTTT
SORBI_3010G199600	GGCCAGGTCATCATCGATCGCTTGCTCGTCGTCTTGACCGCGCCGCTGTTCTGTTCCCTTGCCAGCTTTGCCTGCTGCAAGTTGCCACCTGCTCCTGCAGCGCGGACCTCCACCTGCTCCTCCTCGCCCCTCCCCCTTCCAAAATAAAGCGGGAGGGGGGTGCGGATGGC
